엔엘피	NNG
가락지빵	NNG
가래떡	NNG
가루우유	NNG
가지나물	NNG
간고등어	NNG
간장	NNG
갈비	NNG
갈비탕	NNG
감자튀기	NNG
감자튀김	NNG
강냉이	NNG
강정	NNG
개떡	NNG
개장	NNG
건빵	NNG
겨울냉면	NNG
경편	NNG
계란	NNG
계란덮밥	NNG
계란말이	NNG
고기	NNG
고기겹빵	NNG
고량소주	NNG
고량주	NNG
고로케	NNG
고추가루	NNG
고추장	NNG
고춧가루	NNG
곤밥	NNG
골동반	NNG
곰	NNG
곰국	NNG
공갈빵	NNG
과자	NNG
광동요리	NNG
구멍국수	NNG
구야시	NNG
국	NNG
국물	NNG
국밥	NNG
국수	NNG
국수발	NNG
국수오리	NNG
국숫발	NNG
규돈	NNG
기름밥	NNG
기름사탕	NNG
김	NNG
김밥	NNG
김초밥	NNG
김치	NNG
김치찌개	NNG
까까	NNG
깍두기	NNG
껌	NNG
꼬부랑국수	NNG
꿀	NNG
꿀타래	NNG
꿔바로우	NNG
나박김치	NNG
날김치	NNG
날달걀	NNG
날맥주	NNG
냉라면	NNG
냉면	NNG
녹차	NNG
다코야키	NNG
단디	NNG
단맛감	NNG
단무지	NNG
단물얼음	NNG
단얼음	NNG
달걀	NNG
달걀덮밥	NNG
달걀말이	NNG
닭갈비	NNG
닭강정	NNG
닭개장	NNG
닭고기	NNG
닭고기덮밥	NNG
닭꼬치	NNG
닭튀김	NNG
대굿국	NNG
덮밥	NNG
도넛	NNG
도미빵	NNG
돈가스	NNG
동치미	NNG
돼지고기	NNG
돼지고기덮밥	NNG
된장	NNG
된장찌개	NNG
두부	NNG
디저트	NNG
땅콩과자	NNG
떡	NNG
떡국	NNG
떡꼬치	NNG
떡볶이	NNG
뜨더국	NNG
라면	NNG
라면떡볶이	NNG
라면수프	NNG
라바슈	NNG
라볶이	NNG
럼	NNG
레모네이드	NNG
레몬수	NNG
마가린	NNG
마른반찬	NNG
마른오징어	NNG
마멀레이드	NNG
마요네즈	NNG
마카로니	NNG
마파두부	NNG
막걸리	NNG
막대사탕	NNG
만두	NNG
만두기	NNG
맘마	NNG
맥주	NNG
머스터드	NNG
머스터드소스	NNG
먹거리	NNG
면발	NNG
묵	NNG
문어빵	NNG
물냉면	NNG
미숫가루	NNG
미음	NNG
밀가루	NNG
밀국수	NNG
밀크커피	NNG
바게트	NNG
바비큐	NNG
바삭과자	NNG
박고지	NNG
박하사탕	NNG
밥	NNG
밥감주	NNG
배추김치	NNG
배춧국	NNG
백설탕	NNG
백엽다	NNG
백포도주	NNG
버터	NNG
보드카	NNG
보르시	NNG
보리밥	NNG
보리차	NNG
보릿가루	NNG
보신탕	NNG
보쌈김치	NNG
볶음밥	NNG
부대찌개	NNG
부침개	NNG
분유	NNG
분탕	NNG
불고기	NNG
붕어빵	NNG
브랜디	NNG
블랙커피	NNG
비빔	NNG
비빔냉면	NNG
비빔밥	NNG
빙수	NNG
빠다	NNG
빵	NNG
삐짜	NNG
사이다	NNG
사탕	NNG
사탕가루	NNG
삶은달걀	NNG
삼각김밥	NNG
삼겹살	NNG
삼계탕	NNG
삼두음	NNG
삼정과	NNG
삼합미음	NNG
새우튀김	NNG
샌드위치	NNG
샐러드	NNG
생강주	NNG
생강즙	NNG
생강차	NNG
생김치	NNG
생라면	NNG
생맥주	NNG
생선묵	NNG
생선전	NNG
생선회	NNG
생황장	NNG
샤실리크	NNG
샴팡	NNG
샴페인	NNG
설고	NNG
설고빵	NNG
설기과자	NNG
설기빵	NNG
설탕	NNG
누룽지탕	NNG
탕수육	NNG
라조육	NNG
해삼탕	NNG
잡치	NNG
양장피	NNG
깐풍기	NNG
라조기	NNG
고추잡채	NNG
난자완스	NNG
깐쇼새우	NNG
깐풍육	NNG
해물잡탕	NNG
팔보채	NNG
유산슬	NNG
마파두부	NNG
짜장면	NNG
짬뽕	NNG
우동	NNG
우라회	NNG
울면	NNG
간짜장	NNG
잡채밥	NNG
양송이덮밥	NNG
새우볶음밥	NNG
삼선볶음밥	NNG
마파두부밥	NNG
짜장덮밥	NNG
볶음밥	NNG
유산슬덮밥	NNG
잡탕밥	NNG
삼선짬뽕	NNG
삼선우동	NNG
삼선간짜장	NNG
떡국	NNG
떡만두국	NNG
갈비탕	NNG
왕만두	NNG
육개장	NNG
제육덮밥	NNG
오징어덮밥	NNG
자장	NNG
자장면	NNG
자장밥	NNG
1시	NNG
2시	NNG
3시	NNG
4시	NNG
5시	NNG
6시	NNG
7시	NNG
8시	NNG
9시	NNG
10시	NNG
11시	NNG
12시	NNG
13시	NNG
14시	NNG
15시	NNG
16시	NNG
17시	NNG
18시	NNG
19시	NNG
20시	NNG
21시	NNG
22시	NNG
23시	NNG
24시	NNG
0분	NNG
1분	NNG
2분	NNG
3분	NNG
4분	NNG
5분	NNG
6분	NNG
7분	NNG
8분	NNG
9분	NNG
10분	NNG
11분	NNG
12분	NNG
13분	NNG
14분	NNG
15분	NNG
16분	NNG
17분	NNG
18분	NNG
19분	NNG
20분	NNG
21분	NNG
22분	NNG
23분	NNG
24분	NNG
25분	NNG
26분	NNG
27분	NNG
28분	NNG
29분	NNG
30분	NNG
31분	NNG
32분	NNG
33분	NNG
34분	NNG
35분	NNG
36분	NNG
37분	NNG
38분	NNG
39분	NNG
40분	NNG
41분	NNG
42분	NNG
43분	NNG
44분	NNG
45분	NNG
46분	NNG
47분	NNG
48분	NNG
49분	NNG
50분	NNG
51분	NNG
52분	NNG
53분	NNG
54분	NNG
55분	NNG
56분	NNG
57분	NNG
58분	NNG
59분	NNG
싱싱회	NNG

범백산	NNP
황금산	NNP
고사리	NNP
동대산	NNP
송정동산	NNP
더기산	NNP
정물오름	NNP
경마산	NNP
금대산	NNP
남전산	NNP
태봉	NNP
잣밭구뎅이	NNP
장성봉	NNP
대관령	NNP
붉은오름	NNP
부엉등산	NNP
금병산	NNP
기산봉	NNP
성묘산	NNP
왕제산	NNP
부락산	NNP
가라산	NNP
중앙공원	NNP
새득이봉	NNP
선황산	NNP
월봉산	NNP
회목봉	NNP
여쩌리	NNP
갈현근린공원	NNP
만뢰산	NNP
동림산	NNP
백덕산	NNP
소룡산	NNP
당산	NNP
박산	NNP
적라산	NNP
거말산	NNP
고청봉	NNP
대공원숲길	NNP
어점이	NNP
소산오름	NNP
귀래정	NNP
서학산	NNP
호구산	NNP
부주산	NNP
가수리	NNP
금적산	NNP
팔봉산	NNP
무등산	NNP
큰산	NNP
송비산	NNP
선유산	NNP
박석산	NNP
두백산	NNP
촛대봉	NNP
하양혈리산	NNP
모구리	NNP
금성산	NNP
월성산	NNP
만불산	NNP
삼암봉	NNP
용요산	NNP
박유산	NNP
백양산	NNP
답십리공원	NNP
용문산	NNP
진당산	NNP
초암산	NNP
오룡산	NNP
갈기산	NNP
보납산	NNP
소구니산	NNP
성내삿갓봉	NNP
신반앞산	NNP
감낭오름	NNP
탑산	NNP
화절령	NNP
애막골	NNP
뇌성산	NNP
화학산	NNP
삼의오름	NNP
동달산	NNP
보광사	NNP
승달산	NNP
심재산	NNP
백련산	NNP
배금산	NNP
거북산	NNP
승학산	NNP
거마산장수	NNP
금단산	NNP
호골산	NNP
태백산	NNP
은파호수공원	NNP
민둥산	NNP
쓰레산	NNP
염창산	NNP
왕령산	NNP
구학산	NNP
마보기	NNP
금강소나무길	NNP
상당산성자연휴양림	NNP
민락공원	NNP
나티미기산	NNP
주왕산	NNP
저지오름	NNP
군산	NNP
추동공원	NNP
경옥봉	NNP
위례산	NNP
물무산	NNP
한양아파트뒷산	NNP
노태산	NNP
봉화대	NNP
복수근린공원	NNP
어성전리	NNP
설봉산	NNP
접성산	NNP
남덕유산	NNP
사실골산	NNP
어로리등산로	NNP
갈전곡봉	NNP
매봉재	NNP
봉의산	NNP
인성산	NNP
구병산	NNP
미동산	NNP
부흥산	NNP
봉두산월용리	NNP
검덕산	NNP
새바지산	NNP
만리공원	NNP
쉰음산	NNP
토봉	NNP
산정산	NNP
소소름	NNP
발산	NNP
소금강산	NNP
상왕명덕산	NNP
옥순봉구담봉	NNP
대초산	NNP
단종장릉숲길	NNP
무봉산	NNP
작은성황산	NNP
운길산	NNP
망기봉	NNP
칡오름구좌읍	NNP
백두대간트레일평창	NNP
삼동산	NNP
사패산	NNP
마당재산	NNP
초곡산성	NNP
인왕산	NNP
창안산	NNP
남병산	NNP
전후치	NNP
갈전산	NNP
상정봉	NNP
왕모산	NNP
인정오름	NNP
공작산	NNP
북정산	NNP
반야사둘레길	NNP
동구릉	NNP
드름산	NNP
만경대	NNP
성치산	NNP
병마산	NNP
옥실골산	NNP
달산봉	NNP
보은산	NNP
동구래탐방로	NNP
독봉산	NNP
넉시오름	NNP
한석산	NNP
교동	NNP
군산남고뒷산	NNP
둔덕산	NNP
기룡산	NNP
낭끼	NNP
밝얼산	NNP
송공산	NNP
금남정맥	NNP
월평공원	NNP
문박산	NNP
한남금북정맥	NNP
고인돌둘레길	NNP
몰운대	NNP
국수산	NNP
우산공원	NNP
곤천산	NNP
구와산	NNP
개인산	NNP
망모산	NNP
갑둔고개	NNP
신탄진정수장산림공원	NNP
호명산	NNP
노목산	NNP
황우산	NNP
안흘리길	NNP
곤방산	NNP
마봉산	NNP
보문산	NNP
화개산	NNP
운제산구짐이골	NNP
수산봉	NNP
신성봉	NNP
공산성	NNP
호랑산	NNP
담바우산	NNP
감산리	NNP
대명산	NNP
진악산	NNP
원전벌바위둘레길	NNP
거친오름	NNP
감악산늘목	NNP
왕조산	NNP
이방산	NNP
남한산성	NNP
여계산	NNP
갈라산	NNP
한우산	NNP
견불리산	NNP
고동산	NNP
송의산	NNP
수리봉	NNP
소공대비	NNP
내상산	NNP
우두산	NNP
국수봉	NNP
한반도해송숲	NNP
북오름	NNP
성터	NNP
늑구리숲길	NNP
완택산	NNP
초평트래킹길	NNP
두승산성	NNP
육향산	NNP
계화산	NNP
초례봉	NNP
황방산	NNP
금학산둘레길	NNP
유구리뒷산	NNP
벳터고개	NNP
기린봉	NNP
지각산	NNP
가곡병풍바위	NNP
옥성리뒷산	NNP
운장산	NNP
가마오름	NNP
만리산	NNP
세성산	NNP
도안공원	NNP
백두산	NNP
월경산	NNP
관주산	NNP
철봉산	NNP
조라	NNP
덕산	NNP
불광산	NNP
아양산	NNP
아차산	NNP
노인산	NNP
잔미산	NNP
오갑산	NNP
여분산	NNP
연인산	NNP
금박산	NNP
군왕봉	NNP
철갑령	NNP
반천리	NNP
양정앞산	NNP
석갑산	NNP
본적산	NNP
뇌암산	NNP
뾰루봉	NNP
구현산	NNP
백복령	NNP
동포뒷산	NNP
울련산	NNP
고불봉	NNP
대부산	NNP
양천산	NNP
방아고개	NNP
벙산	NNP
전월산	NNP
노자산	NNP
와야봉	NNP
아미산	NNP
만석산	NNP
대암봉	NNP
바랑산	NNP
고양산	NNP
수청동	NNP
관악산장군봉기점	NNP
수성못뒷산	NNP
마곡사	NNP
안산	NNP
백학산	NNP
바둑고개	NNP
망태봉	NNP
면산	NNP
마복산	NNP
문유산	NNP
백마산	NNP
갈현성	NNP
대모산	NNP
충무공원	NNP
국통산	NNP
쟁기봉	NNP
개천산	NNP
한대오름	NNP
오량산	NNP
조봉	NNP
서산	NNP
망봉산	NNP
시모산	NNP
현산	NNP
석용산	NNP
무룡산	NNP
매봉	NNP
백봉산	NNP
개오름굿산망	NNP
넓적바위산	NNP
가섭산	NNP
병방산	NNP
백약이	NNP
대상골월경산	NNP
봉림산	NNP
장전평	NNP
대덕산	NNP
고백이산	NNP
장척산	NNP
괘장산	NNP
석호산	NNP
백곡산	NNP
원적사	NNP
백두대간트레일	NNP
대신리	NNP
제천동중학교뒷산	NNP
도초산	NNP
천암산	NNP
문산리뒷산	NNP
풍촌	NNP
입곡산림욕장	NNP
주리봉	NNP
황새봉	NNP
물야면사무소뒷산	NNP
큰노리손이	NNP
우렁산	NNP
안봉산	NNP
백수리산	NNP
번암산	NNP
호암산	NNP
보련산	NNP
죽엽산	NNP
족은바리메	NNP
사금산	NNP
관악산학바위능선	NNP
복두산	NNP
호명사뒷산	NNP
금련산	NNP
와우산	NNP
주흘산	NNP
저수령둘레길	NNP
심리산	NNP
잠방골	NNP
봉황산	NNP
기대봉	NNP
둔지봉	NNP
지적산	NNP
북산	NNP
문복산	NNP
천주산누리길	NNP
안천이오름	NNP
만경산	NNP
서원산	NNP
관대리	NNP
잠두봉	NNP
대절산	NNP
방구산	NNP
백하산	NNP
중원산	NNP
망마산	NNP
고봉리산	NNP
박봉산	NNP
인대산	NNP
모후산	NNP
현성산	NNP
사명산	NNP
향적산	NNP
검단리고개	NNP
경운산	NNP
선학산	NNP
신동읍야산	NNP
주정산	NNP
철승산	NNP
거머산	NNP
문수봉	NNP
성수리	NNP
장천면산	NNP
양성산	NNP
비음산	NNP
고이오름	NNP
수명산	NNP
월라산포제동산	NNP
일월산	NNP
삼봉산	NNP
명덕봉	NNP
죽곡산	NNP
삼인산	NNP
신덕산	NNP
비파산	NNP
목우산	NNP
억불산	NNP
뱀째산	NNP
적산	NNP
성령산	NNP
미숭산	NNP
금강소나무숲길	NNP
둔철산	NNP
치마산	NNP
우가산	NNP
상황봉	NNP
퇴메산	NNP
당산봉	NNP
봉명산	NNP
괴병산	NNP
성정산	NNP
운문산	NNP
가마봉	NNP
족은방애오름	NNP
아홉산	NNP
곰배령	NNP
추월산	NNP
망산	NNP
비슬산	NNP
벽화산	NNP
핏대봉	NNP
방장산	NNP
들레오름	NNP
갑하산	NNP
천만산	NNP
덕산계곡	NNP
북배산	NNP
계봉	NNP
삼태봉	NNP
승무산	NNP
존제산	NNP
거문산	NNP
솔봉	NNP
칠사산	NNP
망주산	NNP
칠봉산	NNP
운무산	NNP
무암사	NNP
장산	NNP
괴오름	NNP
쌍용산	NNP
것대산	NNP
금호남정맥	NNP
봉수산숲길	NNP
홍복산	NNP
대포항주변	NNP
도숭산	NNP
진접읍금곡리	NNP
손지오름	NNP
금동산	NNP
반월산	NNP
성무봉	NNP
길상산	NNP
꽃봉산	NNP
지미봉	NNP
보림산	NNP
갈천약수	NNP
마이산	NNP
사룡산	NNP
화락산	NNP
이티봉산성	NNP
월학쉼터	NNP
태수산	NNP
청계산	NNP
보리수마을뒷산	NNP
노루생태공원	NNP
망월산	NNP
어성전	NNP
종자산	NNP
수선산	NNP
수태산	NNP
월봉	NNP
대공산성	NNP
태봉산	NNP
천봉	NNP
푯대봉	NNP
동산	NNP
안락산	NNP
아홉산둘레길	NNP
퇴모산	NNP
탑현골	NNP
초산봉	NNP
대별동산	NNP
청벽산	NNP
첨산	NNP
우성이산	NNP
근산	NNP
은두봉	NNP
민락	NNP
은고개	NNP
법화산	NNP
나시리오름	NNP
견준산	NNP
박대산	NNP
학산	NNP
절골산	NNP
숙지산	NNP
성거산	NNP
식장산	NNP
파리봉	NNP
항가울산	NNP
웅석봉	NNP
충혼탑	NNP
검은덕이오름	NNP
흙붉은이오름주체오름	NNP
구녀산	NNP
은월봉	NNP
포암산	NNP
송내산	NNP
민안초등학교뒷산	NNP
짚봉산	NNP
몽령산	NNP
기마봉	NNP
금원산	NNP
사별산	NNP
무제산	NNP
망해산	NNP
개명산	NNP
몽덕산	NNP
소요산	NNP
내포리야산	NNP
구산근린공원	NNP
석천산	NNP
진해드림로드	NNP
미륵산	NNP
산방산	NNP
희양산	NNP
별도봉	NNP
태숭산	NNP
옥산	NNP
영주산	NNP
마명산	NNP
율도	NNP
따라비	NNP
각성산	NNP
관모산	NNP
기린공원	NNP
불당산	NNP
하서산	NNP
호음산	NNP
덤바위산	NNP
조산봉	NNP
삼문산	NNP
마안산	NNP
구름산	NNP
제비봉	NNP
월이산	NNP
사두봉	NNP
봉암산	NNP
혈구산	NNP
덕령산	NNP
굴암산	NNP
왕이산	NNP
이끼폭포	NNP
마중오름	NNP
가대리문화마을	NNP
수리산	NNP
호남정맥	NNP
두타산	NNP
고덕산	NNP
건의령	NNP
덕봉	NNP
방아달산	NNP
두류산	NNP
발산분덕재	NNP
은적산	NNP
댓재옛길	NNP
작오산	NNP
백이산	NNP
천치산	NNP
양각산	NNP
행치봉	NNP
매산	NNP
남산근린공원	NNP
신기산	NNP
금정산	NNP
은이산	NNP
고락산	NNP
교룡산	NNP
석름봉	NNP
가지산	NNP
점봉산	NNP
지등산	NNP
사우당앞산	NNP
잠곡초교뒷산	NNP
대공원산	NNP
묘봉산	NNP
각화사	NNP
대운산	NNP
녹두봉	NNP
세미오름	NNP
거머리산	NNP
덕포숲길	NNP
서오릉	NNP
최악산	NNP
용화산	NNP
성산일출봉	NNP
달음산	NNP
황령산	NNP
퇴뫼산일원	NNP
가은산	NNP
영남알프스둘레길	NNP
남포둘릴산	NNP
배미산	NNP
황학산	NNP
천마봉	NNP
밥봉	NNP
능암덕산	NNP
노꼬메큰오름	NNP
학가산	NNP
봉화봉	NNP
마구산	NNP
시어산	NNP
새별오름	NNP
양자산	NNP
망운산	NNP
운교산	NNP
양달산	NNP
무학봉	NNP
벽방산	NNP
진조산	NNP
운봉산책로	NNP
영태산	NNP
덕산봉	NNP
성지봉	NNP
초산연지길	NNP
분성산	NNP
알오름	NNP
꼭지산	NNP
조운산	NNP
마니산	NNP
희리산	NNP
연점산	NNP
목포시립도서관뒷산	NNP
송포약수터	NNP
임경업장군묘소	NNP
강씨봉	NNP
봉화산	NNP
광덕산	NNP
범바위	NNP
성화산	NNP
성진이오름	NNP
폭낭오름	NNP
죽전리뒷산	NNP
돈달산	NNP
다랑쉬오름	NNP
오성산	NNP
입봉	NNP
성불오름	NNP
여항산	NNP
마금산	NNP
동두산	NNP
용날등	NNP
나각산	NNP
적석산	NNP
장수봉	NNP
내동산	NNP
문안산신당재	NNP
영취산	NNP
국사봉시루봉	NNP
성암산	NNP
보리골	NNP
영경묘	NNP
원효봉	NNP
느지리오름	NNP
내연산	NNP
지력산	NNP
고려산	NNP
금강으로가는하늘숲길	NNP
앞산	NNP
태화근린공원	NNP
덕고산	NNP
노성산	NNP
팔용산	NNP
선각산	NNP
출동산	NNP
칠탄산	NNP
소뿔산	NNP
남산	NNP
새암산	NNP
노추산	NNP
봉정산	NNP
남원중뒷산	NNP
비래산	NNP
누운오름	NNP
마로산	NNP
제지기오름	NNP
천생산	NNP
절물오름	NNP
사라봉	NNP
서망봉	NNP
소똥령	NNP
백암산	NNP
광진리	NNP
관악산	NNP
심척리마을뒷산	NNP
시래산	NNP
문래산	NNP
대방산	NNP
복주깨봉	NNP
두봉산	NNP
감토산	NNP
새동네뒷산	NNP
꽃산	NNP
발리리뒷산	NNP
금남호남정맥	NNP
수월봉	NNP
소당산	NNP
옥마산	NNP
오태동산	NNP
큰걸쇠	NNP
준경묘주변산	NNP
도덕봉	NNP
각산	NNP
축융봉	NNP
원당봉	NNP
오서산	NNP
빈네오름	NNP
금오산	NNP
천아오름	NNP
마락산	NNP
무척산	NNP
주읍산	NNP
내현리산	NNP
별산	NNP
원장봉	NNP
봉화별량	NNP
생기악	NNP
고근산	NNP
송화산	NNP
독수정원림	NNP
임호산	NNP
원미산	NNP
안마산	NNP
당경산	NNP
대니산	NNP
연암산	NNP
달마산	NNP
개좌산	NNP
안수산	NNP
법정악	NNP
고적대	NNP
망령산	NNP
초암산수남	NNP
복주산	NNP
도음산	NNP
선바위산	NNP
천운산	NNP
무선산	NNP
풍락산	NNP
팔강산	NNP
적벽산	NNP
자배봉	NNP
대도사뒷산	NNP
홍릉공원	NNP
함박산	NNP
광월산	NNP
구봉산물통골	NNP
감투봉	NNP
월영봉	NNP
덕항산	NNP
자산동야산	NNP
퇴비산	NNP
용암산	NNP
용강산	NNP
파군봉	NNP
고성산	NNP
번널오름	NNP
서북산	NNP
먹뱅이산	NNP
새덕산	NNP
아트홀	NNP
가학산	NNP
구마산	NNP
정물알오름	NNP
안평산	NNP
구룡령옛길	NNP
동맥이산	NNP
동화산	NNP
은봉산	NNP
소주봉	NNP
낙가산	NNP
쌍교봉	NNP
문형산	NNP
가덕도	NNP
부귀산	NNP
무이산	NNP
추화산	NNP
원적산	NNP
도화리	NNP
바리메	NNP
상은적산	NNP
포항시청뒷산	NNP
창암산	NNP
가양공원	NNP
팔음산	NNP
육신사	NNP
방애오름	NNP
송학산	NNP
고창읍성	NNP
개금산	NNP
응암산	NNP
상리공원	NNP
제암산	NNP
이배재고개	NNP
임원해맞이공원	NNP
상하수내리봉	NNP
관심산	NNP
연징산	NNP
불갑산	NNP
망일산	NNP
용진산	NNP
태행산	NNP
신선약수터	NNP
궁대	NNP
간대산	NNP
자시산성산	NNP
오산	NNP
소재골	NNP
군유산	NNP
사마산	NNP
성산	NNP
한도골계곡	NNP
대동산	NNP
수도산	NNP
각히산	NNP
도락산	NNP
노루손이오름	NNP
봉황봉	NNP
수양산	NNP
낙천리	NNP
만지산	NNP
석성산	NNP
봉미산	NNP
통명산	NNP
북분리	NNP
당산봉알봉	NNP
동망봉	NNP
덕갈산	NNP
어등산	NNP
명성산	NNP
북면사무소뒷산	NNP
왕산	NNP
선도산	NNP
영인산	NNP
대금산두밀리고개	NNP
국민의숲트레킹	NNP
송악산	NNP
초록봉	NNP
덕태산	NNP
상주산	NNP
식산	NNP
금주산	NNP
운봉산	NNP
제주올레길한림고내올레	NNP
비학산	NNP
마평동산	NNP
신봉산	NNP
망경대산	NNP
호점산성	NNP
태산봉	NNP
버무덕골산	NNP
꽃봉	NNP
고리봉	NNP
새봉	NNP
단풍산	NNP
흰대미	NNP
초피산	NNP
봉개민오름	NNP
가재산금병산수양산줄기	NNP
삼정산성	NNP
백운산	NNP
대비오름	NNP
고봉산	NNP
선소오름	NNP
해망산	NNP
제석산	NNP
성동산	NNP
구성산	NNP
발교산	NNP
대미산	NNP
베틀산	NNP
대봉	NNP
주미산	NNP
명동재	NNP
장령산	NNP
용장산	NNP
성재	NNP
활오름	NNP
홍산	NNP
연대봉	NNP
봉화산죽도봉	NNP
금이광이	NNP
범바위산	NNP
흑석산	NNP
장동고개	NNP
삼학도	NNP
채죽산	NNP
토곡산	NNP
가련산	NNP
유덕봉	NNP
송현리	NNP
영남산	NNP
별립산	NNP
조령산	NNP
부모산	NNP
용암산등산로	NNP
선방산	NNP
백병봉	NNP
울산바위	NNP
인대산가리막골	NNP
덕대산	NNP
신무산	NNP
화방산	NNP
함지산	NNP
임봉산	NNP
상소동산림욕장	NNP
가오공원	NNP
소학산	NNP
남북종주	NNP
만덕산	NNP
큰골숲길	NNP
갯거리오름	NNP
국사봉매봉	NNP
북돌아진오름	NNP
첨찰산	NNP
학미산	NNP
봉덕산	NNP
묵장산	NNP
선달산	NNP
향교뒷산	NNP
태복산	NNP
인등산	NNP
익산토성둘레길	NNP
미봉산	NNP
망경대	NNP
봉서산	NNP
보양지산	NNP
봉천산	NNP
용소골	NNP
불회사	NNP
망경산	NNP
봉복산	NNP
자굴산둘레길	NNP
평성산	NNP
보현산	NNP
삼락산	NNP
금골산사리암	NNP
도고산	NNP
물찻오름	NNP
진부령	NNP
소남산	NNP
반론산	NNP
월미산	NNP
열왕산	NNP
화채봉	NNP
와수리	NNP
화산	NNP
기우산	NNP
양을산	NNP
작은산	NNP
함박봉	NNP
화진포소나무숲산림욕장	NNP
무랑골	NNP
가성산	NNP
취연정	NNP
바데산	NNP
윤산	NNP
영장산	NNP
천아숲길	NNP
와룡산	NNP
인의산	NNP
승비산	NNP
광진산	NNP
도봉산	NNP
건흥산	NNP
덕산산	NNP
송학정	NNP
불령산	NNP
근남면	NNP
감악산	NNP
북성산	NNP
예성산	NNP
천왕산	NNP
용추산	NNP
금당산숲길	NNP
경신산	NNP
명덕산	NNP
북면사무소앞산	NNP
삼선산	NNP
부금산	NNP
문학산	NNP
청화산	NNP
미타산	NNP
주봉산	NNP
금오름	NNP
진관근린공원	NNP
현천뒷산	NNP
광대산	NNP
개화산	NNP
가음산	NNP
초안산	NNP
월류봉	NNP
금계산	NNP
둔병재어림재	NNP
검봉산	NNP
삿갓봉	NNP
우암산	NNP
시목해수욕장숲길	NNP
팔각산둘레길	NNP
백호산	NNP
낙동정맥	NNP
등곡산	NNP
돈지공원	NNP
적오산	NNP
북봉산	NNP
건지산	NNP
마파산	NNP
단월산	NNP
정풍산	NNP
산세미오름	NNP
백우산	NNP
시대산	NNP
수질환경사업소뒷편	NNP
토함산	NNP
염포산	NNP
만덕봉	NNP
승봉산	NNP
낙화암	NNP
우면산	NNP
삼현리	NNP
독용산	NNP
고부랑고개	NNP
죽장봉화봉	NNP
묘봉미남봉	NNP
함각산	NNP
도두봉	NNP
강섭산	NNP
마대산	NNP
뾰족산	NNP
두리봉	NNP
신병산	NNP
신기산성	NNP
연화산투구봉	NNP
지라안산	NNP
석현공원뒷산	NNP
좌구산	NNP
돈대미	NNP
안양산	NNP
평지산	NNP
강바위산	NNP
서림산	NNP
석기봉	NNP
연석산	NNP
취암산	NNP
간성수성샘터산림욕장	NNP
용마산	NNP
황룡산	NNP
천의봉	NNP
군자봉	NNP
입석리	NNP
펀치볼둘레길	NNP
복음산	NNP
설림산	NNP
사자목이산	NNP
방태산	NNP
용우이산	NNP
옥화자연휴양림	NNP
주발봉	NNP
가래봉	NNP
소미산	NNP
좌방산	NNP
인경산	NNP
연추골계곡	NNP
두방산	NNP
구룡산	NNP
감투산	NNP
다가산	NNP
느태뒷산	NNP
박난봉	NNP
보록산	NNP
수인산	NNP
만리포중학교뒷산	NNP
앵봉산	NNP
무학산용두산	NNP
대덕봉	NNP
금봉산	NNP
못골산	NNP
삼학산	NNP
경포대시루봉	NNP
서리산	NNP
인내산	NNP
강선봉	NNP
해월산	NNP
천장봉	NNP
형제봉	NNP
천관산	NNP
녹남봉	NNP
벽옥산	NNP
하사앞산	NNP
보리산	NNP
감방산	NNP
안돌오름	NNP
까끄레기	NNP
용천리산	NNP
안세미	NNP
화양골둘레길	NNP
백아산	NNP
용암봉	NNP
금장산	NNP
갈리봉	NNP
망설봉	NNP
범바위봉	NNP
모산봉	NNP
청우산	NNP
용화곡내골	NNP
낙화산	NNP
백두대간동해전망대	NNP
어림산	NNP
당오름	NNP
병암산	NNP
소리산	NNP
약수숲길	NNP
산장산	NNP
새리골	NNP
삼천공원	NNP
관람산	NNP
귀목봉	NNP
신평리산책로	NNP
칠산	NNP
만남의광장구포도서관	NNP
피래산	NNP
영은사뒷산	NNP
성태산	NNP
영병산	NNP
노랭이봉	NNP
어음성산	NNP
선의산	NNP
송정자연휴양림	NNP
태재고개	NNP
만연산	NNP
서수모루	NNP
봉화군청뒷산	NNP
외솔봉	NNP
거류산	NNP
중전리당두산입구	NNP
천태산	NNP
약산	NNP
족은녹고메	NNP
무학산둘레길	NNP
보안산	NNP
미석산	NNP
백두대간트레일인제	NNP
해안면	NNP
뱀산	NNP
남산골	NNP
달바위봉	NNP
청암산	NNP
천아초낭오름	NNP
작약산	NNP
백석봉	NNP
운악산	NNP
해룡산	NNP
백안산	NNP
황장산	NNP
삼매봉	NNP
약수봉	NNP
방가산	NNP
백석산	NNP
포성봉	NNP
숙성산	NNP
유방산	NNP
구르뫼산	NNP
상산	NNP
더데오름	NNP
궁동산	NNP
단석산	NNP
갈방산	NNP
고산봉	NNP
꾀꼬리봉	NNP
쇠기오름	NNP
통오름	NNP
쌍문동공원	NNP
고루포기산	NNP
고장산	NNP
순사이산	NNP
성주봉	NNP
불당골산	NNP
퇴뫼산	NNP
본지오름	NNP
비래바위	NNP
향로산	NNP
봉두산	NNP
유건에오름	NNP
삼년산성	NNP
세걸산	NNP
삼보산	NNP
마산	NNP
성재산	NNP
마산봉	NNP
중부산성	NNP
대아수목원	NNP
기역산	NNP
경수산	NNP
좌구산자연휴양림	NNP
건령산	NNP
종재기악	NNP
화왕산	NNP
견두산	NNP
청등산	NNP
까치절산	NNP
정광산	NNP
남산산림욕장	NNP
마산동산성	NNP
와룡산무학사	NNP
돌봉산	NNP
덕성산	NNP
임암산	NNP
연호산	NNP
덕지산	NNP
청량산	NNP
함월산평산골	NNP
성주산	NNP
병무산	NNP
용계산	NNP
대전시경계종주	NNP
반용산	NNP
오정산	NNP
오두재	NNP
재약산	NNP
매고개	NNP
갈경산	NNP
오계치깃대봉	NNP
광려산	NNP
할매산	NNP
나산	NNP
억불봉	NNP
현달산	NNP
노인봉	NNP
재래봉	NNP
비나봉	NNP
신선산솔마루길	NNP
대성산	NNP
각흘산	NNP
삼호산	NNP
선야봉	NNP
구봉대산	NNP
홍곡산	NNP
풍악산	NNP
미궐산	NNP
상원산	NNP
두승산	NNP
장군산	NNP
대야산성	NNP
능동산	NNP
울미산	NNP
밖돌오름	NNP
나팔봉	NNP
방골산	NNP
개머리산	NNP
백두대간만항재	NNP
망일봉	NNP
고초봉	NNP
장성산	NNP
별악봉	NNP
장근봉	NNP
족은사슴이	NNP
석화산	NNP
병풍산	NNP
조소산	NNP
왕의산	NNP
고모치	NNP
상해봉	NNP
신어산	NNP
건배산	NNP
부용산	NNP
태청산	NNP
스무골	NNP
사랑산	NNP
무갑산	NNP
금수산	NNP
독묘산	NNP
금강산	NNP
역촌근린공원	NNP
배재산	NNP
동해동산	NNP
부개산	NNP
만월산	NNP
중수봉	NNP
알프스환종주	NNP
고비산	NNP
노고산	NNP
구봉화산	NNP
개인산어두원골	NNP
고토재산	NNP
덕우봉	NNP
입화산	NNP
망객산	NNP
영암산	NNP
검은오름	NNP
대록산	NNP
안장산	NNP
이구산	NNP
조침령	NNP
수레의산	NNP
구수산	NNP
월명산	NNP
수정산	NNP
곤봉산	NNP
배담재	NNP
영문산	NNP
남망산	NNP
좌보미	NNP
예봉산	NNP
오리골	NNP
독재봉	NNP
시루산	NNP
이동산	NNP
계룡산	NNP
성봉	NNP
과녁바위산	NNP
유지등산	NNP
무학산	NNP
마천산	NNP
앞오름	NNP
두루봉산	NNP
등운산	NNP
선석산	NNP
가좌산	NNP
팔공산	NNP
상소산	NNP
막장봉	NNP
월출봉	NNP
황석산	NNP
천반산	NNP
다구리야산	NNP
벼락바위봉	NNP
내산	NNP
김대중모실길	NNP
등고산	NNP
횡악산	NNP
화야산	NNP
학정봉	NNP
부용봉	NNP
삼준산	NNP
수악	NNP
대왕산	NNP
희아산	NNP
배매산	NNP
수문산	NNP
악희봉	NNP
만세봉	NNP
산성산	NNP
민주지산	NNP
입산	NNP
금남산	NNP
염수봉	NNP
매곡산	NNP
수타리봉	NNP
상광정리	NNP
금물산	NNP
배방산	NNP
금남정맥안골산	NNP
노적산	NNP
하왕도리산	NNP
장원봉	NNP
갈야산	NNP
윤산둘레길	NNP
문명산	NNP
대야산	NNP
진강산	NNP
거진해맞이봉산림욕장	NNP
원등산	NNP
금북정맥	NNP
새방골산	NNP
매악산	NNP
갑장산	NNP
봉대산	NNP
상정바위	NNP
천호산	NNP
연봉산	NNP
가메오름	NNP
어답산	NNP
합미봉	NNP
사곡계실	NNP
안심산	NNP
저명산	NNP
상남리	NNP
대룡폭포	NNP
마성산	NNP
동백길	NNP
종남산	NNP
초록산	NNP
장학산	NNP
복호산	NNP
도름산	NNP
물박물관	NNP
도장산	NNP
중봉산	NNP
백룡산	NNP
옥녀암	NNP
양로봉	NNP
석봉	NNP
독자봉	NNP
정안국사봉	NNP
구룡산산림욕장	NNP
꼬추봉	NNP
속금산	NNP
극정봉	NNP
수박등	NNP
덕정산	NNP
월암산	NNP
태조봉	NNP
대잠동센트럴	NNP
상아산	NNP
앞메산	NNP
정배산	NNP
큰산임도	NNP
중근봉	NNP
조비산	NNP
천마산	NNP
퇴미산	NNP
성미산	NNP
장태봉	NNP
검은들먹오름	NNP
은석산	NNP
유명산	NNP
가시악	NNP
함백산오투리조트	NNP
각화산	NNP
팔룡산	NNP
옹성산	NNP
어성산	NNP
분적산	NNP
응해산	NNP
구룡골통골	NNP
노상산	NNP
성황산	NNP
고인돌	NNP
마차봉	NNP
고은산	NNP
도너리오름	NNP
모락산	NNP
백적산	NNP
족은지그리오름	NNP
울릉군숲길	NNP
왕치산	NNP
고수치	NNP
희망봉	NNP
삼정대산	NNP
주월산	NNP
춘갑봉	NNP
둔주봉	NNP
구곡산	NNP
황태봉	NNP
제추골	NNP
섯알오름	NNP
오구시오름	NNP
봉화산계남	NNP
왕가산	NNP
정도리구계등	NNP
황매산	NNP
질현성	NNP
상학봉	NNP
신사근린공원	NNP
상양혈리	NNP
매봉산	NNP
화악산	NNP
복두봉	NNP
황악산	NNP
설오름	NNP
자굴산	NNP
월학리마을뒷산	NNP
여치산	NNP
절산	NNP
화부산	NNP
소곡산	NNP
장리산	NNP
화시봉	NNP
동국대뒷산	NNP
광제봉	NNP
천주산	NNP
철미산	NNP
장등산	NNP
알프스태극종주	NNP
세정사	NNP
청룡산	NNP
도덕산	NNP
능천산	NNP
시루봉	NNP
호등산	NNP
방계산	NNP
시궁산	NNP
오얏골	NNP
속리산둘레길	NNP
한남정맥	NNP
서화산	NNP
일산봉	NNP
삽존리	NNP
일림산	NNP
시랑산	NNP
두수골	NNP
중미산	NNP
서대산	NNP
민오름	NNP
자란산	NNP
개오름	NNP
주금산	NNP
봉오리산	NNP
걸쇠오름	NNP
명봉산	NNP
덕태산백운마을	NNP
청송자연휴양림	NNP
양산봉	NNP
천택산	NNP
철암	NNP
가세오름	NNP
구룡산오무골	NNP
이성산	NNP
지장산	NNP
백자산	NNP
청명산	NNP
가리왕산	NNP
왕이메	NNP
갑산	NNP
천성산	NNP
감의산	NNP
이계오름	NNP
강망산	NNP
성지산	NNP
주주봉	NNP
칡오름상효동	NNP
두치산	NNP
장륙산	NNP
수하청소년수련원뒷산	NNP
망밭	NNP
태백산악훈련장	NNP
함라산	NNP
사월초뒷산	NNP
이기대도시자연공원	NNP
적상산	NNP
괴화산	NNP
문암산	NNP
호태산	NNP
연화산	NNP
보평산	NNP
만수산	NNP
용달산	NNP
무성산	NNP
유주산	NNP
제철동	NNP
숲데미산	NNP
송라산	NNP
성관사뒷길	NNP
운흥산	NNP
마국산	NNP
매원산	NNP
소치마을뒷산	NNP
구나무산	NNP
비슬산권역	NNP
아기산	NNP
불곡산	NNP
대조봉	NNP
삼성산	NNP
장락산	NNP
노릿재	NNP
매봉산산림욕장	NNP
무지개산	NNP
소팽이산책로	NNP
사려니숲길	NNP
금전산	NNP
오서산이봉걸골	NNP
삼청리뒷산	NNP
장수산	NNP
고헌산	NNP
마적산	NNP
이달이촛대봉	NNP
홍도산	NNP
금당산	NNP
남이장군로	NNP
신선산	NNP
태백산둘레길	NNP
사갓봉	NNP
교래임도	NNP
두만리산	NNP
문안산	NNP
운달산	NNP
용눈이오름	NNP
상운면사무소앞산	NNP
대암산	NNP
앵산	NNP
미녀봉	NNP
회룡포뒷산	NNP
송계리	NNP
동악산둘레길	NNP
상금리	NNP
후봉	NNP
덕우산	NNP
가산	NNP
미약산	NNP
불암산	NNP
저도비치로드	NNP
마등산	NNP
상가임도숲길	NNP
오석산	NNP
봉실산	NNP
지족산	NNP
일광산	NNP
석문산	NNP
마향산	NNP
석두산	NNP
논오름	NNP
연화봉	NNP
용산	NNP
건봉산	NNP
잣봉	NNP
백월산	NNP
한재	NNP
범어공원	NNP
판암근린공원	NNP
방광산	NNP
원산	NNP
오로산	NNP
간월산	NNP
다래오름	NNP
곤지산	NNP
금채산	NNP
대금산	NNP
박달봉	NNP
숭림산	NNP
왕재산	NNP
갈마산	NNP
이달봉	NNP
진봉산	NNP
사자산	NNP
느림보강물길	NNP
삼방산	NNP
구뎅이산	NNP
괘관산	NNP
성흥산	NNP
세미소은총의동산	NNP
초롱산	NNP
도비산	NNP
봉두암산	NNP
기양산	NNP
상정국사봉	NNP
묵방산	NNP
공덕산	NNP
집현산	NNP
사월산	NNP
마집봉	NNP
마래산	NNP
감바위산	NNP
구덕산	NNP
송산	NNP
초점산	NNP
함월산	NNP
장정산	NNP
서당산	NNP
자모산	NNP
원수산	NNP
망대암산	NNP
남은골둘레길	NNP
수암산	NNP
마항산	NNP
조록바위봉	NNP
망나니고개	NNP
김개남장군묘	NNP
거망산	NNP
골무산	NNP
일성산	NNP
앵무산	NNP
민주지산불대	NNP
월선봉	NNP
부지산	NNP
검단산	NNP
대전둘레길만인산	NNP
물영아리	NNP
짝바위등산로	NNP
우마장산	NNP
까치산	NNP
팔각산	NNP
봉무공원	NNP
이목리	NNP
월방산	NNP
신선봉	NNP
석병산	NNP
섭지코지	NNP
대봉산	NNP
장복산	NNP
단봉산	NNP
수락산	NNP
망진산	NNP
접산	NNP
모악산	NNP
숲뒤산	NNP
효렴산	NNP
금귀봉	NNP
장재덕	NNP
동막산	NNP
돗대산	NNP
왕방산	NNP
노적봉	NNP
비계산	NNP
나래산	NNP
불태산	NNP
부쇠봉	NNP
지억산	NNP
무량산	NNP
수중동산	NNP
아가봉	NNP
호산	NNP
지봉산	NNP
대렴봉	NNP
불화산	NNP
이승악	NNP
문봉산	NNP
방어산	NNP
감암산	NNP
백병산	NNP
원촌뒷산	NNP
돔박이	NNP
옥교산	NNP
양학산	NNP
변동근린공원	NNP
바라산자연휴양림	NNP
관호산	NNP
골체오름	NNP
석가산	NNP
승안산	NNP
된봉	NNP
포도산	NNP
북종산	NNP
백족산	NNP
가덕산	NNP
구인산	NNP
숲솔나들이길	NNP
함라산둘레길	NNP
백악산	NNP
통방산	NNP
태악산노인봉성재봉	NNP
감악산약수터	NNP
삼발랭산	NNP
자산	NNP
구봉산	NNP
구미산	NNP
용인등봉	NNP
탄항산	NNP
운암산	NNP
허굴산	NNP
박달산	NNP
연내골	NNP
청옥산	NNP
원대봉	NNP
덕음산	NNP
화리치	NNP
운주산	NNP
백토	NNP
안개산	NNP
수패봉	NNP
옥녀산	NNP
운지악	NNP
향산	NNP
본신마을	NNP
왕개산	NNP
눈오름	NNP
원당산	NNP
죽도산	NNP
건등산	NNP
서방산	NNP
파산	NNP
성곡산	NNP
장군바위산	NNP
원대제	NNP
박월산	NNP
불모산	NNP
설산	NNP
여귀산	NNP
관악산삼봉약수터	NNP
거문오름	NNP
주지봉	NNP
옥녀봉	NNP
감토산숲길	NNP
북악산	NNP
함봉산	NNP
청계산원터	NNP
축령산	NNP
반륜산	NNP
바라산	NNP
새신오름	NNP
족두리봉아래	NNP
검암산	NNP
문수산	NNP
귓물오름	NNP
갈미봉	NNP
미림산	NNP
느릅재	NNP
수덕산	NNP
운제산	NNP
계방산	NNP
태기산	NNP
삼산삼림욕장	NNP
청대산	NNP
환희산	NNP
동광산	NNP
산내초교뒷산	NNP
덕봉산	NNP
덕기봉	NNP
봉수산	NNP
석대산	NNP
연모리산	NNP
운이덕	NNP
환성산	NNP
발왕산	NNP
시묘산	NNP
어수산	NNP
천비산	NNP
선왕산	NNP
상봉산	NNP
기선봉	NNP
내곡동	NNP
윤개해안	NNP
대포저수지	NNP
땅재봉	NNP
인후공원	NNP
천곡산성	NNP
보광산	NNP
북바위산	NNP
돌오름길	NNP
우장산	NNP
취국산	NNP
웅산	NNP
오봉산	NNP
정족산	NNP
극락오름	NNP
독바위산	NNP
우금산	NNP
밧세미오름	NNP
가현산금곡초	NNP
회문산	NNP
옥계리야산	NNP
갈모봉산	NNP
둔군봉	NNP
회봉산	NNP
배봉산	NNP
보덕봉	NNP
명지산	NNP
구절산	NNP
적대봉	NNP
금강산화암사숲길	NNP
소래산	NNP
종고산	NNP
삼정산	NNP
가현산	NNP
오서산성동	NNP
불광근린공원	NNP
감악산연수사	NNP
돌구산	NNP
단지봉	NNP
병곳	NNP
공개바위	NNP
만항산	NNP
정각산	NNP
천보산	NNP
악견산	NNP
고하도	NNP
계명산	NNP
천진샘터	NNP
만인산	NNP
신불산	NNP
곰봉	NNP
부산	NNP
금덩산	NNP
인단산	NNP
고산	NNP
옥봉산	NNP
비상산성	NNP
우락산	NNP
송림산	NNP
월대산	NNP
영축산	NNP
뾔족산	NNP
정수산	NNP
칠갑산	NNP
도계대덕산	NNP
잠용산	NNP
삼형제봉	NNP
자암산	NNP
성수산	NNP
장복산마진터널	NNP
서독산	NNP
분지봉	NNP
작은월랑봉	NNP
일봉산	NNP
북망산	NNP
와리산	NNP
철마산	NNP
남산숲길	NNP
태화산	NNP
묘고산	NNP
냉산	NNP
둥글메산	NNP
봉제산	NNP
경천대	NNP
작성산	NNP
국지산	NNP
평안산	NNP
각시바위	NNP
덕암산	NNP
덕가산	NNP
남산봉	NNP
백두대간건의령고적대	NNP
삼형제샛오름	NNP
반약산	NNP
작은걸쇠	NNP
제왕산	NNP
외범이산	NNP
칠보산	NNP
동성산	NNP
토끼봉	NNP
산내주공아파트뒷산	NNP
각흘산석이바위	NNP
거마산	NNP
취북산	NNP
큰도래미오름	NNP
동암산	NNP
뒷굽은이오름	NNP
명도봉	NNP
한남지선	NNP
안덕중학교뒷산	NNP
채계산	NNP
봉산	NNP
집다리골	NNP
학사리	NNP
식장산둘레길	NNP
오음산	NNP
두억봉	NNP
연미산	NNP
수북산	NNP
해넘이등산로	NNP
백화산	NNP
빈계산	NNP
죽림산	NNP
좌이산	NNP
만어산	NNP
응봉산	NNP
공원산	NNP
안기산	NNP
봉래산	NNP
대둔산	NNP
서운산	NNP
횟골산	NNP
망덕봉	NNP
봉대산쪽매골	NNP
광교산	NNP
덕동산	NNP
팔암산	NNP
금산	NNP
원통산	NNP
노악산	NNP
됨봉	NNP
내영산	NNP
돌고개	NNP
첩푸산	NNP
운월산	NNP
장자산	NNP
달봉산	NNP
샘봉산	NNP
천방산	NNP
칠성산	NNP
화장산	NNP
곡달산	NNP
검마산	NNP
칡오름봉개동	NNP
수종사	NNP
개오리오름	NNP
인재개발원화명수목원	NNP
서우봉	NNP
배산	NNP
남송이	NNP
적변산	NNP
주산	NNP
봉산리	NNP
법산	NNP
용산산성	NNP
호두산	NNP
두위봉	NNP
서재골	NNP
가칠봉	NNP
진월국사봉	NNP
국사봉	NNP
대곡산	NNP
우두봉	NNP
계양산	NNP
용뫼산	NNP
배래치골산	NNP
장군봉	NNP
대자산	NNP
오드싱오름	NNP
검무봉	NNP
공주향교뒷산	NNP
천장산	NNP
지산동산	NNP
성불산	NNP
향산리둘레길	NNP
보암산	NNP
계봉산	NNP
덕룡산	NNP
선두산	NNP
바우오름	NNP
정병산	NNP
국망봉	NNP
흑성산	NNP
화산공원	NNP
남암산	NNP
벽암산	NNP
소수리산	NNP
천봉산	NNP
설화산	NNP
한산	NNP
상리리동산	NNP
고내봉	NNP
용천산	NNP
열안지오름	NNP
노로오름	NNP
북한산	NNP
보해산	NNP
불기산	NNP
일산	NNP
금음산	NNP
조항산	NNP
알진오름	NNP
금무산	NNP
삼태산	NNP
다사매곡정수장	NNP
한북정맥	NNP
깃대봉	NNP
황산	NNP
넙게오름	NNP
오두산	NNP
주렴산	NNP
오식도산	NNP
말목산	NNP
오대산	NNP
금학산	NNP
장암산	NNP
창수산	NNP
엄혜산	NNP
더퍼리골	NNP
원수악	NNP
고래산	NNP
장미산	NNP
이명산	NNP
대전산책로	NNP
중태산	NNP
비봉산	NNP
계족산성	NNP
각골산	NNP
조양동선사유적지	NNP
경각산	NNP
원덕읍사무소뒷산	NNP
운계봉	NNP
오십천산책로	NNP
거린오름	NNP
함백산	NNP
천등산	NNP
회령봉	NNP
언애바위산	NNP
등배산	NNP
두밀령	NNP
백아산목장	NNP
관산	NNP
향로봉	NNP
갈두산	NNP
계족산	NNP
용소봉	NNP
예촌망	NNP
삼수령	NNP
녹번동근린공원	NNP
망해봉	NNP
현리산	NNP
발한동	NNP
두무산	NNP
숙호산	NNP
바늘오름	NNP
삼각산	NNP
눌의산	NNP
대지산	NNP
뒷산한치고개	NNP
야훼동산	NNP
로방산	NNP
구만산	NNP
대수산봉	NNP
영천악	NNP
궁산	NNP
한천산	NNP
봉곡동산	NNP
새깃대봉	NNP
중경산	NNP
왕두산	NNP
천황산	NNP
완산공원	NNP
판문산	NNP
기백산	NNP
어룡산	NNP
돌람산	NNP
토산봉	NNP
월여산	NNP
비룡산	NNP
서룡산	NNP
수정리야산	NNP
말곡리산	NNP
백운봉	NNP
유학산	NNP
최정산	NNP
소수산봉	NNP
온의등산로	NNP
당두산	NNP
할미산	NNP
돈대이	NNP
용암리산책로	NNP
상운산	NNP
이터산	NNP
운암정	NNP
수정봉	NNP
잠두산	NNP
금골산	NNP
향수산	NNP
하추리산막골	NNP
가야산	NNP
망치산	NNP
과오름	NNP
대룡산	NNP
어비산	NNP
삼악산	NNP
선자산	NNP
용두산	NNP
정혜산	NNP
팔영산	NNP
굴봉산	NNP
비조봉	NNP
각희산	NNP
억산	NNP
십리봉	NNP
어도오름	NNP
인산리구간	NNP
위봉마을구간	NNP
산천마을	NNP
입구구간	NNP
쌍이리구간	NNP
본동구간	NNP
공기리구간	NNP
목동리구간	NNP
천곡동구간	NNP
오서리구간	NNP
수암봉	NNP
입구구간	NNP
북동리구간	NNP
답곡리구간	NNP
구례길구간	NNP
서대문구홍은동구간	NNP
내리구간	NNP
당항리구간	NNP
안산초등학교구간	NNP
약수터구간	NNP
용연리구간	NNP
가음면현리리구간	NNP
할미산길구간	NNP
나전리구간	NNP
금진리구간	NNP
인경리구간	NNP
지량리구간	NNP
팔성리구간	NNP
덕지리구간	NNP
덕리구간	NNP
화명동구간	NNP
하광교동구간	NNP
중군동구간	NNP
오기리구간	NNP
두포리구간	NNP
절부길구간	NNP
월피동구간	NNP
일신리구간	NNP
대곡동구간	NNP
대대리구간	NNP
삼각리구간	NNP
탄방동구간	NNP
상평리구간	NNP
창동리구간	NNP
신흥동구간	NNP
궁평리구간	NNP
익산시모현동구간	NNP
옥동리구간	NNP
주약동구간	NNP
덕송리구간	NNP
금오산채미정정문옆구간	NNP
옥산동구간	NNP
덕례리구간	NNP
우록리구간	NNP
지현리구간	NNP
학산리구간	NNP
월남파병용사만남의장	NNP
뒤구간	NNP
탑원리구간	NNP
자은동구간	NNP
숭오리구간	NNP
역평리구간	NNP
성리구간	NNP
오전리구간	NNP
금정리구간	NNP
족은지그리오름구간	NNP
소길리구간	NNP
영천동구간	NNP
은골마을	NNP
입구구간	NNP
무안리구간	NNP
마봉리구간	NNP
이십곡리구간	NNP
당동구간	NNP
구갈동구간	NNP
가야동구간	NNP
외감리구간	NNP
구산길구간	NNP
성동구간	NNP
서천리구간	NNP
오성리구간	NNP
옥거리구간	NNP
매음리구간	NNP
화제리구간	NNP
강림리구간	NNP
금창리구간	NNP
남부민동구간	NNP
봉두리구간	NNP
명서리구간	NNP
용현동구간	NNP
용반리구간	NNP
입석길구간	NNP
삼정동구간	NNP
송치리구간	NNP
옥평리구간	NNP
봉대리구간	NNP
원서리구간	NNP
문동동구간	NNP
궁촌리구간	NNP
무월길구간	NNP
충령탑진입로구간	NNP
충무동구간	NNP
안천리구간	NNP
덕천리구간	NNP
월영동구간	NNP
대포리구간	NNP
백야리구간	NNP
와리구간	NNP
송계리구간	NNP
상예동구간	NNP
대금리구간	NNP
만덕리구간	NNP
삼교리구간	NNP
향소리구간	NNP
본산리구간	NNP
남장리구간	NNP
영덕동구간	NNP
모곡리구간	NNP
대청동구간	NNP
지지리구간	NNP
장암리구간	NNP
팔당리구간	NNP
와석리구간	NNP
월길리구간	NNP
행정리구간	NNP
궁항리구간	NNP
사리구간	NNP
무룡동구간	NNP
해문리구간	NNP
산하동구간	NNP
정양리구간	NNP
옥림리구간	NNP
남노송동구간	NNP
화원읍	NNP
본리구간	NNP
한삼천리구간	NNP
동산동구간	NNP
주북리구간	NNP
대관령옛길구간	NNP
도원동구간	NNP
덕암리구간	NNP
대성리구간	NNP
입암동구간	NNP
다목리구간	NNP
서오리구간	NNP
내탐길구간	NNP
소룡리구간	NNP
문형리구간	NNP
원보광길구간	NNP
능암리구간	NNP
동교동구간	NNP
해저리구간	NNP
천남리구간	NNP
장짐리구간	NNP
기린봉아파트구간	NNP
지문리구간	NNP
동두천동구간	NNP
전대리구간	NNP
용지리구간	NNP
홍원리구간	NNP
방태산등산로구간	NNP
성황동구간	NNP
물량리구간	NNP
서룡리구간	NNP
죽산리구간	NNP
산호리구간	NNP
병목안	NNP
은행나무집	NNP
고가밑구간	NNP
상계리구간	NNP
교방동구간	NNP
운수동구간	NNP
월산동구간	NNP
갈천동구간	NNP
공안리구간	NNP
대화리구간	NNP
마달동구간	NNP
서중동구간	NNP
교항리구간	NNP
대산리구간	NNP
형곡동낙타봉옆입구구간	NNP
황산리구간	NNP
정상동구간	NNP
공릉동구간	NNP
산내초등학교뒤구간	NNP
무도리구간	NNP
교동리구간	NNP
하호리구간	NNP
효리구간	NNP
궁근정리구간	NNP
동막리구간	NNP
대원리구간	NNP
경반리구간	NNP
미암리구간	NNP
삼정리구간	NNP
병산리구간	NNP
애산리구간	NNP
신양리구간	NNP
수남리구간	NNP
석교동구간	NNP
광평리구간	NNP
평림동구간	NNP
남북리구간	NNP
하신리구간	NNP
대정리구간	NNP
신교리구간	NNP
대룡리구간	NNP
명덕수원지구간	NNP
차리구간	NNP
삼거리구간	NNP
신율리구간	NNP
노은리구간	NNP
오로리구간	NNP
회원동구간	NNP
위곡리구간	NNP
덕호리구간	NNP
신곡리구간	NNP
사동리구간	NNP
석운동구간	NNP
신상리구간	NNP
산성우리구간	NNP
퇴계동구간	NNP
군사리구간	NNP
세종리구간	NNP
도락산빙벽장	NNP
산유리구간	NNP
중황리구간	NNP
걸은리구간	NNP
옥하리구간	NNP
신등리구간	NNP
산포리구간	NNP
대교리구간	NNP
월내동구간	NNP
용곡리구간	NNP
단천리구간	NNP
감악재길구간	NNP
신경리구간	NNP
월산리구간	NNP
완월동구간	NNP
관산리구간	NNP
운서동구간	NNP
남천리구간	NNP
십이리구간	NNP
사계리구간	NNP
중대리구간	NNP
파수리구간	NNP
고성군	NNP
간성읍	NNP
탑현리구간	NNP
상성리구간	NNP
회룡리구간	NNP
완산공원	NNP
주차장위구간	NNP
남현동구간	NNP
남양동구간	NNP
상직리구간	NNP
덕계동구간	NNP
태성리구간	NNP
봉룡리구간	NNP
마전리구간	NNP
진리구간	NNP
호동구간	NNP
개명리구간	NNP
남산동구간	NNP
원대리구간	NNP
수봉리구간	NNP
신무동구간	NNP
괘석리구간	NNP
축서사구간	NNP
사석리구간	NNP
동광리구간	NNP
용평동구간	NNP
유촌리구간	NNP
자혜리구간	NNP
도봉동구간	NNP
어천리구간	NNP
관촉동구간	NNP
전포동구간	NNP
봉암리구간	NNP
다호리구간	NNP
명호면관창리구간	NNP
행곡리구간	NNP
송능리구간	NNP
구계리구간	NNP
방춘리구간	NNP
사둔리구간	NNP
청송리구간	NNP
서상리구간	NNP
객현리구간	NNP
갈계길구간	NNP
당동길구간	NNP
매계리구간	NNP
덕적리구간	NNP
내현리구간	NNP
퇴촌동구간	NNP
교성리구간	NNP
세량리구간	NNP
무봉리구간	NNP
사등리구간	NNP
구암동구간	NNP
동변리구간	NNP
금동리구간	NNP
상읍리구간	NNP
봉암동구간	NNP
안대리구간	NNP
대치리구간	NNP
둘레길구간	NNP
율석리구간	NNP
발양리구간	NNP
사기막리구간	NNP
장원리구간	NNP
금강도길구간	NNP
성남동구간	NNP
용암사구간	NNP
나리구간	NNP
인창동구간	NNP
갈현동구간	NNP
이문동구간	NNP
서도리구간	NNP
초부리구간	NNP
장용리구간	NNP
백석동구간	NNP
비동리구간	NNP
장리구간	NNP
원포동구간	NNP
도량동구간	NNP
어방동구간	NNP
추점리구간	NNP
저구리구간	NNP
의양리구간	NNP
상동동구간	NNP
여천동구간	NNP
범곡리구간	NNP
광곡리구간	NNP
삼화동구간	NNP
덕촌리구간	NNP
원남리구간	NNP
예수리구간	NNP
반교리구간	NNP
금마리구간	NNP
무선저수지구간	NNP
오림동구간	NNP
상송리구간	NNP
요양병원길구간	NNP
가곡동구간	NNP
토산리구간	NNP
병천리구간	NNP
죽곡동구간	NNP
원지리구간	NNP
용앙리구간	NNP
하원리구간	NNP
양덕동구간	NNP
강동길구간	NNP
신대리구간	NNP
수산리구간	NNP
수리산	NNP
산림욕장	NNP
앞구간	NNP
율진리구간	NNP
상평동구간	NNP
수양리구간	NNP
쌍학리구간	NNP
석동구간	NNP
수평리구간	NNP
운정동구간	NNP
창신리구간	NNP
해운리구간	NNP
월암리구간	NNP
서수리구간	NNP
독천리구간	NNP
왕촌리구간	NNP
쌍율리구간	NNP
가수리구간	NNP
은평구관음길구간	NNP
고양리구간	NNP
표선리구간	NNP
관고동구간	NNP
호계동구간	NNP
석모리구간	NNP
하안미리구간	NNP
방광리구간	NNP
선동구간	NNP
이의동구간	NNP
청계산	NNP
임도구간	NNP
청학리구간	NNP
학조리구간	NNP
계실리구간	NNP
부평동구간	NNP
시기동구간	NNP
담산동구간	NNP
북곡리구간	NNP
수서동구간	NNP
후동리구간	NNP
궁내동구간	NNP
금봉리구간	NNP
관교동구간	NNP
효교리구간	NNP
여방리구간	NNP
월봉산길구간	NNP
백곡리구간	NNP
외동리구간	NNP
어산리구간	NNP
평창리구간	NNP
모전리구간	NNP
진북동구간	NNP
위태리구간	NNP
장상리구간	NNP
신세동구간	NNP
조촌동구간	NNP
산하리구간	NNP
평성리구간	NNP
평창동구간	NNP
원당사구간	NNP
산내리구간	NNP
귤암리구간	NNP
장야리구간	NNP
중촌리구간	NNP
선암리구간	NNP
수포대길구간	NNP
운촌리구간	NNP
일신아파트구간	NNP
조양동구간	NNP
청천리구간	NNP
병풍리구간	NNP
만수천구가	NNP
고렴리구간	NNP
조평리구간	NNP
사봉리구간	NNP
봉곡리구간	NNP
은하리구간	NNP
내가천리구간	NNP
갈현리구간	NNP
내흥리구간	NNP
고산리구간	NNP
오색리구간	NNP
양악리구간	NNP
홍익아파트구간	NNP
괴정리구간	NNP
앙암마을구간	NNP
하리구간	NNP
대원사구간	NNP
삼동구간	NNP
동춘동구간	NNP
원촌마을구간	NNP
거리구간	NNP
계리구간	NNP
지경리구간	NNP
도천동구간	NNP
조안리구간	NNP
가학동구간	NNP
공북리구간	NNP
상림리구간	NNP
특리구간	NNP
오항리구간	NNP
취생리구간	NNP
감천리구간	NNP
창봉리구간	NNP
고도리구간	NNP
우치리구간	NNP
상동리구간	NNP
방촌동구간	NNP
아리랑비구간	NNP
쌍문동구간	NNP
내남동구간	NNP
강정리구간	NNP
오록리구간	NNP
와우리구간	NNP
화양리구간	NNP
죽계리구간	NNP
신촌리구간	NNP
양리구간	NNP
죽청리구간	NNP
약전리구간	NNP
동당리구간	NNP
율량동구간	NNP
생곡리구간	NNP
포전리구간	NNP
부성리구간	NNP
내흥동구간	NNP
구고리구간	NNP
상아동구간	NNP
산천리구간	NNP
암치리구간	NNP
녹동리구간	NNP
평촌동구간	NNP
창촌리구간	NNP
항가리구간	NNP
오상리구간	NNP
법상동구간	NNP
천흥리구간	NNP
매산리구간	NNP
사곡리구간	NNP
중태리구간	NNP
왕사입구구간	NNP
월문리구간	NNP
홍감길구간	NNP
예곡동구간	NNP
금학동구간	NNP
신림동구간	NNP
월암동구간	NNP
판문동구간	NNP
동상동구간	NNP
황룡리구간	NNP
죽토리구간	NNP
길두리구간	NNP
가안리구간	NNP
둔동길구간	NNP
아미산둘레길	NNP
의귀리구간	NNP
광의리구간	NNP
내가면고천리구간	NNP
구문소관광지등산로	NNP
율치리구간	NNP
계룡리구간	NNP
노대동구간	NNP
휘경동구간	NNP
미곡리구간	NNP
광진리구간	NNP
화정동구간	NNP
상대리구간	NNP
마동구간	NNP
소태동구간	NNP
연성리구간	NNP
염포동구간	NNP
세교동구간	NNP
공세동구간	NNP
건지리구간	NNP
시량리구간	NNP
아천리구간	NNP
임원리구간	NNP
주어리구간	NNP
소사동구간	NNP
하산곡동구간	NNP
개곡리구간	NNP
내평리구간	NNP
등광리구간	NNP
석호리구간	NNP
소전리구간	NNP
영승길구간	NNP
윤필암구간	NNP
방흥리구간	NNP
위라리구간	NNP
목림이길구간	NNP
산북동구간	NNP
성포리구간	NNP
삼교	NNP
저수지구간	NNP
지동동구간	NNP
용명리구간	NNP
굴운리구간	NNP
감연리구간	NNP
천불사구간	NNP
법주리구간	NNP
파장동구간	NNP
동면임당리구간	NNP
안낭월길입구구간	NNP
우두령마을길구간	NNP
홍천세무소구간	NNP
화은리구간	NNP
남통동고개주차장입구구간	NNP
서대문구홍은동산구간	NNP
문원동구간	NNP
장천리구간	NNP
역곡동구간	NNP
간문리구간	NNP
선포아파트정문구간	NNP
봉한리구간	NNP
용호동구간	NNP
수청리구간	NNP
시립박물관구간	NNP
호현동구간	NNP
남하리구간	NNP
금전동구간	NNP
성재마을	NNP
입구구간	NNP
남천동구간	NNP
대현리구간	NNP
천부리구간	NNP
세곡동구간	NNP
두암동구간	NNP
세성리구간	NNP
식천리구간	NNP
죽청마을구간	NNP
계내리구간	NNP
망미동구간	NNP
내동길구간	NNP
녹래리구간	NNP
고탄리구간	NNP
웃장팔길구간	NNP
정족리구간	NNP
강석리구간	NNP
삼계동구간	NNP
덕곡리구간	NNP
장산리구간	NNP
미평동구간	NNP
기사리구간	NNP
대라리구간	NNP
검율리구간	NNP
목재펠릿공장구간	NNP
내예리구간	NNP
어남동구간	NNP
위미리구간	NNP
병내리구간	NNP
감곡리구간	NNP
소매리구간	NNP
성곡리구간	NNP
진인동구간	NNP
쟁암리구간	NNP
서정동구간	NNP
상두리구간	NNP
팔용산돌탑공원구간	NNP
부평시립도서관구간	NNP
각서리구간	NNP
예리구간	NNP
오운리구간	NNP
화동리구간	NNP
대동리구간	NNP
호산동구간	NNP
연주리구간	NNP
안기동구간	NNP
한성농축원입구구간	NNP
이인리구간	NNP
연지동구간	NNP
금고동구간	NNP
천내리구간	NNP
어로리구간	NNP
신농리구간	NNP
금암동구간	NNP
수암리구간	NNP
용봉리구간	NNP
구미리구간	NNP
척곡리구간	NNP
안인리구간	NNP
만산동구간	NNP
반제리구간	NNP
신계리구간	NNP
생곡동구간	NNP
명지동구간	NNP
죽정리구간	NNP
진영리구간	NNP
샛단길구간	NNP
계월리구간	NNP
말응리구간	NNP
한남리구간	NNP
축산리구간	NNP
수분리구간	NNP
연안중장비	NNP
학원구간	NNP
천동리구간	NNP
상남리구간	NNP
내덕동구간	NNP
금이산성순환로구간	NNP
양대리구간	NNP
오사동구간	NNP
삼랑리구간	NNP
상대동구간	NNP
반죽동구간	NNP
신장리구간	NNP
산전리구간	NNP
나운동구간	NNP
구림리구간	NNP
고천리구간	NNP
관호리구간	NNP
묵계리구간	NNP
고막리구간	NNP
하반천리구간	NNP
상방리구간	NNP
봉포리구간	NNP
마령리구간	NNP
금구리구간	NNP
소곡리구간	NNP
다대동구간	NNP
오곡리구간	NNP
우성아파트	NNP
옆	NNP
주차장구간	NNP
숭신공고구간	NNP
부산리구간	NNP
옥녀봉구간	NNP
팬터탑스빌구간	NNP
복성리구간	NNP
서대문구	NNP
동구물길구간	NNP
평정리구간	NNP
목상동솔밭구간	NNP
점리구간	NNP
현천리구간	NNP
현동리구간	NNP
덕천서원길구간	NNP
지촌리구간	NNP
흥동구간	NNP
죽동길구간	NNP
보산원리구간	NNP
어인길구간	NNP
수도암구간	NNP
소답동구간	NNP
둔곡동구간	NNP
북일면	NNP
임도구간	NNP
와룡리구간	NNP
대진리구간	NNP
안산동구간	NNP
팔송리구간	NNP
관리사무소구간	NNP
용강리구간	NNP
남정동구간	NNP
웅곡리구간	NNP
내칠리구간	NNP
내동구간	NNP
서암리구간	NNP
창조교회구간	NNP
선학리구간	NNP
연덕리구간	NNP
호암산문구간	NNP
안양시	NNP
병목안	NNP
앞구간	NNP
봉강리구간	NNP
노성리구간	NNP
서광리구간	NNP
상호리구간	NNP
임리구간	NNP
검암리구간	NNP
녹문리구간	NNP
영문리구간	NNP
신월동구간	NNP
시지동구간	NNP
임천리구간	NNP
범어동구간	NNP
천호리구간	NNP
목동구간	NNP
부호리구간	NNP
노학동구간	NNP
딸기농원구간	NNP
평내동구간	NNP
운계리구간	NNP
두만리구간	NNP
저지리구간	NNP
평거동구간	NNP
지곡동구간	NNP
용연동구간	NNP
송호리구간	NNP
운중동구간	NNP
성포동구간	NNP
청수동구간	NNP
아리랑고개구간	NNP
검마산자연휴양림매표소구간	NNP
교현리구간	NNP
연정리구간	NNP
장촌리구간	NNP
금오산저수지옆입구구간	NNP
오비리구간	NNP
상촌리구간	NNP
구병리구간	NNP
율포리구간	NNP
문방리구간	NNP
삼숭동구간	NNP
쌍전리구간	NNP
충효동구간	NNP
태봉동구간	NNP
향동동구간	NNP
양백리구간	NNP
계양구	NNP
목상동구간	NNP
고기동구간	NNP
보전리구간	NNP
봉산리구간	NNP
장평동구간	NNP
범물동구간	NNP
쌍용빌라구간	NNP
남방동구간	NNP
진안읍구간	NNP
임곡리구간	NNP
신효동구간	NNP
구룡리구간	NNP
초곡리구간	NNP
외가천리구간	NNP
장곡동구간	NNP
견불리구간	NNP
용소폭포매표소구간	NNP
하점면창후리구간	NNP
반송리구간	NNP
삼분리구간	NNP
노원리구간	NNP
두곡리구간	NNP
탑정리구간	NNP
현리구간	NNP
서벽리구간	NNP
돈산리구간	NNP
토교리구간	NNP
직동구간	NNP
두척동구간	NNP
노송리구간	NNP
구랑동구간	NNP
배알미동구간	NNP
공리구간	NNP
후탄리구간	NNP
도경동구간	NNP
벽제동구간	NNP
노이리구간	NNP
유량동구간	NNP
하진부리구간	NNP
오태동구간	NNP
송성리구간	NNP
병지방리구간	NNP
원성재마을구간	NNP
독산동구간	NNP
찜질방구간	NNP
문학동구간	NNP
황산길구간	NNP
광전리구간	NNP
구산리구간	NNP
북분리구간	NNP
쌍계리구간	NNP
잠곡리구간	NNP
하왕도리구간	NNP
죽림동구간	NNP
일원동구간	NNP
문경새재주차장구간	NNP
구곡폭포주차장구간	NNP
오방리구간	NNP
상개동구간	NNP
유운리구간	NNP
장명동구간	NNP
중계리구간	NNP
음기길구간	NNP
성기리구간	NNP
소야길구간	NNP
덕현리구간	NNP
진중리구간	NNP
구운리구간	NNP
호원동구간	NNP
하대리구간	NNP
덕두원리구간	NNP
망설봉길구간	NNP
고복저수지	NNP
갈림길구간	NNP
용천리구간	NNP
문암리구간	NNP
보덕리구간	NNP
동회동구간	NNP
기린봉주유소구간	NNP
추성리구간	NNP
원풍리구간	NNP
석동리구간	NNP
대류리구간	NNP
옥현리구간	NNP
상창리구간	NNP
아미산구간	NNP
신기동구간	NNP
서대문구홍은동홍은초등학교서문구	NNP
형곡동청일궁전아파트입구구간	NNP
대사동구간	NNP
화포리구간	NNP
죽동리구간	NNP
미원리구간	NNP
소암리구간	NNP
거의동구간	NNP
전척리구간	NNP
정각사구간	NNP
과역리구간	NNP
문강리구간	NNP
벽지리구간	NNP
광월리구간	NNP
엄홍길전시관구간	NNP
소촌동구간	NNP
신매동구간	NNP
원등리구간	NNP
마암리구간	NNP
용당동구간	NNP
구룡포리구간	NNP
중봉리구간	NNP
오봉리구간	NNP
무전리구간	NNP
어현동구간	NNP
대망리구간	NNP
쇠실길구간	NNP
하동구간	NNP
율동리구간	NNP
함덕리구간	NNP
곰실길구간	NNP
칠곡리구간	NNP
권빈리구간	NNP
성북리구간	NNP
철마약수터구간	NNP
군업리구간	NNP
임은동구간	NNP
신기길구간	NNP
백련리구간	NNP
호음단맥	NNP
원당동구간	NNP
운주리구간	NNP
오태동어린이집입구구간	NNP
망상동구간	NNP
주진동구간	NNP
율도동구간	NNP
노기리구간	NNP
석현리구간	NNP
우복리구간	NNP
서대문구홍연길구간	NNP
금호동성실길구간	NNP
복산동구간	NNP
구기리구간	NNP
오라이동구간	NNP
성신리구간	NNP
답십리동구간	NNP
장열리구간	NNP
두복리구간	NNP
학교리구간	NNP
백화리구간	NNP
죽연리구간	NNP
평광동구간	NNP
비룡리구간	NNP
온직리구간	NNP
화계리구간	NNP
당동리구간	NNP
공평동구간	NNP
고모동구간	NNP
인람리구간	NNP
추동리구간	NNP
외포리구간	NNP
길곡리구간	NNP
석장동구간	NNP
구의동구간	NNP
호명리구간	NNP
종달리구간	NNP
정수사구간	NNP
이패동구간	NNP
용담리구간	NNP
궐동구간	NNP
도천리구간	NNP
온혜리구간	NNP
호근동구간	NNP
삼성리구간	NNP
삽재고개구간	NNP
석사동구간	NNP
온수리구간	NNP
효자동구간	NNP
녹진리구간	NNP
쌍곡리구간	NNP
상도리구간	NNP
안녕동구간	NNP
회정리구간	NNP
한천리구간	NNP
성북동구간	NNP
내법리구간	NNP
암산굴구간	NNP
향천리구간	NNP
시응골길구간	NNP
달천리구간	NNP
성진이오름구간	NNP
성성동구간	NNP
산북리구간	NNP
문죽리구간	NNP
품안리구간	NNP
수정리구간	NNP
용아리구간	NNP
신내동구간	NNP
범어리구간	NNP
현동구간	NNP
삼옥리구간	NNP
장신리구간	NNP
양등리구간	NNP
원리리구간	NNP
마산동구간	NNP
홍대연수원앞등산로입구구간	NNP
추계리구간	NNP
계촌리구간	NNP
삼현리구간	NNP
맹리구간	NNP
금암리구간	NNP
상왕동구간	NNP
중대동구간	NNP
금남리구간	NNP
취평리구간	NNP
상양명	NNP
주차장구간	NNP
광덕사구간	NNP
연호동구간	NNP
물한계곡구간	NNP
용순리구간	NNP
세천동구간	NNP
갑동구간	NNP
용흥리구간	NNP
가교리구간	NNP
백안동구간	NNP
천장리구간	NNP
삼덕리구간	NNP
둔덕동구간	NNP
운악산매표소구간	NNP
화봉리구간	NNP
모동리구간	NNP
만덕동구간	NNP
각리구간	NNP
신봉리구간	NNP
제대리구간	NNP
고은초등학교왼쪽구간	NNP
신동구간	NNP
봉림동구간	NNP
가촌리구간	NNP
안덕리구간	NNP
봉전리구간	NNP
연축동구간	NNP
사호리구간	NNP
유곡리구간	NNP
망경동구간	NNP
하사미동구간	NNP
호탄리구간	NNP
축동리구간	NNP
우두령길구간	NNP
고양근린공원	NNP
맞은편구간	NNP
동명동구간	NNP
주차장구간	NNP
전포매리구간	NNP
광명리구간	NNP
은파교회구간	NNP
승안리구간	NNP
창포동구간	NNP
초읍동구간	NNP
물왕동구간	NNP
제령리구간	NNP
화봉동구간	NNP
안양리구간	NNP
항사리구간	NNP
장단리구간	NNP
구라리구간	NNP
석봉리구간	NNP
청운동구간	NNP
택지돈대맞은편구간	NNP
오태동오태수산건너편입구구간	NNP
두밀리구간	NNP
금호동구간	NNP
오곡동구간	NNP
대감리구간	NNP
와동구간	NNP
주례리구간	NNP
교원연수원주차장구간	NNP
금천리구간	NNP
신정리구간	NNP
송대리구간	NNP
압곡리구간	NNP
태백리구간	NNP
풍곡리구간	NNP
학당리구간	NNP
두마리구간	NNP
유암리구간	NNP
동현리	NNP
마을회관구간	NNP
비전동구간	NNP
포일동구간	NNP
꼬리밭길구간	NNP
시문리구간	NNP
산동리구간	NNP
입곡리구간	NNP
대안동구간	NNP
백둔리구간	NNP
원북리구간	NNP
대흥리구간	NNP
오음리구간	NNP
남통동주차장고개아래입구구간	NNP
하양혈리구간	NNP
동백동구간	NNP
유구리구간	NNP
용운리구간	NNP
가세기마을구간	NNP
평장리구간	NNP
능원리구간	NNP
래태리구간	NNP
장현리구간	NNP
부춘리구간	NNP
가평역구간	NNP
열미리구간	NNP
추목리구간	NNP
아화리구간	NNP
초당동구간	NNP
소법리구간	NNP
증거리구간	NNP
방림리구간	NNP
송천리구간	NNP
유교리구간	NNP
옥산리구간	NNP
황학리구간	NNP
태장리구간	NNP
서부리구간	NNP
제월리구간	NNP
범일동구간	NNP
신애리구간	NNP
영남동구간	NNP
병동리구간	NNP
용해동구간	NNP
마차리구간	NNP
연곡리구간	NNP
지내길구간	NNP
북정동구간	NNP
철마농원구간	NNP
원우리구간	NNP
중묵리구간	NNP
동성리구간	NNP
의산리구간	NNP
홍현리구간	NNP
백동리구간	NNP
속곡리구간	NNP
장안동구간	NNP
속달동구간	NNP
사곡동사랑의교회입구구간	NNP
감은리구간	NNP
금계리구간	NNP
예안리구간	NNP
용하리구간	NNP
은포리구간	NNP
우래리구간	NNP
동정동구간	NNP
유서리구간	NNP
문양리구간	NNP
조월리구간	NNP
매호동구간	NNP
동내리구간	NNP
신산리구간	NNP
소룡동구간	NNP
부개동구간	NNP
혈동구간	NNP
중구	NNP
태화동구간	NNP
하안동구간	NNP
국조전구간	NNP
계천리구간	NNP
강진리구간	NNP
도계동구간	NNP
내공리구간	NNP
심리구간	NNP
태백시황지동구간	NNP
하추리구간	NNP
백현리구간	NNP
신천리구간	NNP
선두리구간	NNP
선당리구간	NNP
지석동구간	NNP
강천리구간	NNP
봉능리구간	NNP
칠장리구간	NNP
삼하리구간	NNP
장성동구간	NNP
광성리구간	NNP
풍호리구간	NNP
교래리구간	NNP
보천리구간	NNP
비산동구간	NNP
진평동구간	NNP
물한리구간	NNP
월평리구간	NNP
한우산숨길구간	NNP
다남동구간	NNP
기양리구간	NNP
문화동구간	NNP
유목정리구간	NNP
금치리구간	NNP
분당동구간	NNP
송선리구간	NNP
월외리구간	NNP
월전리구간	NNP
오산길구간	NNP
선행리구간	NNP
이전리구간	NNP
남서리구간	NNP
달제리구간	NNP
궁도장구간	NNP
연보리구간	NNP
임도	NNP
임곡동구간	NNP
속실리구간	NNP
덕우리구간	NNP
하림리구간	NNP
미점리구간	NNP
용성리구간	NNP
군서리구간	NNP
정혜사	NNP
보문유치원구간	NNP
구덕리구간	NNP
두산그린맨션아파트옆입구구간	NNP
대별동구간	NNP
정리구간	NNP
노장리구간	NNP
봉양리구간	NNP
송단리구간	NNP
다솜리구간	NNP
광대리구간	NNP
강당리구간	NNP
중구약사동구간	NNP
하청리구간	NNP
신파리구간	NNP
행현리구간	NNP
이목리구간	NNP
남산유스호스텔뒷길구간	NNP
덕흥리구간	NNP
파동구간	NNP
호정리구간	NNP
하태동리구간	NNP
갑둔리구간	NNP
석평리구간	NNP
부일리구간	NNP
등촌동구간	NNP
탑연리구간	NNP
운남동구간	NNP
번개약수터구간	NNP
정동진리구간	NNP
양재동구간	NNP
백두대간트레일구간	NNP
상전면월포리구간	NNP
남통동백숙식당뒤입구구간	NNP
신원길구간	NNP
무선리구간	NNP
송암리구간	NNP
고잔동구간	NNP
병방동구간	NNP
학산길구간	NNP
청양리구간	NNP
양유리구간	NNP
인평동구간	NNP
음현리구간	NNP
외초리구간	NNP
조남동구간	NNP
매성리구간	NNP
모악리구간	NNP
범도리구간	NNP
배티길구간	NNP
대야미동구간	NNP
도문동구간	NNP
동상면사람들구간	NNP
남통동구미여중옆입구구간	NNP
매정리구간	NNP
성석동구간	NNP
석계리구간	NNP
계양리구간	NNP
서대문구연서길구간	NNP
축현리구간	NNP
금광동구간	NNP
신한리구간	NNP
이사동구간	NNP
원수리구간	NNP
대자동구간	NNP
사기막저수지구간	NNP
세장리구간	NNP
장위리구간	NNP
충무시설	NNP
우측구간	NNP
호계리구간	NNP
비래동구간	NNP
송백리구간	NNP
용미리구간	NNP
주례동구간	NNP
주미동구간	NNP
자산리구간	NNP
남율리구간	NNP
회상리구간	NNP
내곡동구간	NNP
고당리구간	NNP
벚꽃공원길구간	NNP
연구리구간	NNP
장덕리구간	NNP
평안리구간	NNP
증평성요셉공원구간	NNP
괴곡동구간	NNP
수능리구간	NNP
사곡동숯가마우측입구구간	NNP
봉수리구간	NNP
일동구간	NNP
신천동구간	NNP
과정리구간	NNP
강촌리구간	NNP
낙양동구간	NNP
당오리구간	NNP
왕정동구간	NNP
행성리구간	NNP
감물리구간	NNP
용우이산구간	NNP
운안동구간	NNP
강화군강화읍구간	NNP
명관리구간	NNP
용상동구간	NNP
구미예식장뒤입구구간	NNP
효동구간	NNP
송촌동구간	NNP
심곡본동구간	NNP
금릉동구간	NNP
정장리구간	NNP
대보리구간	NNP
팔현리구간	NNP
봉덕동구간	NNP
수옥리구간	NNP
봉개동구간	NNP
한국전력시설물구간	NNP
송내동구간	NNP
속초리구간	NNP
지내리구간	NNP
학하리구간	NNP
나대리구간	NNP
봉당리구간	NNP
오가마을구간	NNP
문곡동구간	NNP
금갑리구간	NNP
성상리구간	NNP
망월길구간	NNP
영흥리구간	NNP
관지리구간	NNP
부용리구간	NNP
통정리구간	NNP
양묘장구간	NNP
배봉리구간	NNP
탑동리구간	NNP
일암리구간	NNP
도장리구간	NNP
계화리구간	NNP
대이리구간	NNP
득암리구간	NNP
시흥계곡구간	NNP
주진리구간	NNP
산현동구간	NNP
삼가리구간	NNP
부리구간	NNP
청천동구간	NNP
송하동구간	NNP
두현리구간	NNP
옥봉동구간	NNP
문장리구간	NNP
나호리구간	NNP
신동리구간	NNP
평리구간	NNP
선구동구간	NNP
예산리구간	NNP
문수동구간	NNP
신현리구간	NNP
가곡리구간	NNP
월오동구간	NNP
박곡리구간	NNP
철수리구간	NNP
화전동구간	NNP
추산동구간	NNP
원박리구간	NNP
천포리구간	NNP
영주동구간	NNP
단계동구간	NNP
세안길구간	NNP
기각리구간	NNP
금동구간	NNP
사모바위길구간	NNP
노산리구간	NNP
송공리구간	NNP
하회리구간	NNP
강운리구간	NNP
위양리구간	NNP
괴전동구간	NNP
상내리구간	NNP
도요리구간	NNP
종합휴양관광지입구구간	NNP
이목동구간	NNP
계동길구간	NNP
유곡동구간	NNP
왕산리구간	NNP
인제동구간	NNP
대은리구간	NNP
불목리구간	NNP
덕동동구간	NNP
남상리구간	NNP
상리동	NNP
세방골구간	NNP
쌍지리구간	NNP
보라동구간	NNP
부귀리구간	NNP
장유동구간	NNP
덕정리구간	NNP
능주향교구간	NNP
외동구간	NNP
창천리구간	NNP
내서리구간	NNP
가동리구간	NNP
정릉동구간	NNP
안지랑골주차장구간	NNP
우라리구간	NNP
도돈리구간	NNP
산본동구간	NNP
금대리구간	NNP
이례리구간	NNP
신송리구간	NNP
창동	NNP
초안산구간	NNP
서덕지길구간	NNP
가양동구간	NNP
와촌면강학리구간	NNP
마성리구간	NNP
하단동구간	NNP
대흥동구간	NNP
양수리구간	NNP
논공읍	NNP
초곡리구간	NNP
명도리구간	NNP
덕선리구간	NNP
입점리구간	NNP
명개리구간	NNP
갈두리구간	NNP
양평리구간	NNP
북가현리구간	NNP
상판리구간	NNP
상갈동구간	NNP
북실리구간	NNP
다가동구간	NNP
화전리구간	NNP
합천리구간	NNP
중추리구간	NNP
가남리구간	NNP
난산리구간	NNP
법왕사	NNP
좌측길구간	NNP
방내리구간	NNP
가수원동구간	NNP
주월동구간	NNP
녹양동구간	NNP
독산자연공원구간	NNP
양학리구간	NNP
반계리구간	NNP
교리구간	NNP
녹번동구간	NNP
하성리구간	NNP
덕진동구간	NNP
토진리구간	NNP
과천동구간	NNP
인리구간	NNP
월성리구간	NNP
웅포리구간	NNP
군표시	NNP
속달동	NNP
산구간	NNP
사자암구간	NNP
대야동구간	NNP
상옥리구간	NNP
서성리구간	NNP
상매동구간	NNP
중흥동구간	NNP
어은리구간	NNP
비례리구간	NNP
보통리구간	NNP
율생리구간	NNP
두두리구간	NNP
요고리구간	NNP
선구리구간	NNP
제석리구간	NNP
관산동구간	NNP
삼덕동구간	NNP
왕궁아파트구간	NNP
대진글라스입구구간	NNP
봉의리구간	NNP
죽림리구간	NNP
서호동구간	NNP
서화면	NNP
심적리구간	NNP
봉강동구간	NNP
상교리구간	NNP
하성길구간	NNP
중구성안동구간	NNP
전지로구간	NNP
오생리구간	NNP
명동구간	NNP
이천동구간	NNP
부수동구간	NNP
하빈면	NNP
묘리구간	NNP
금오산자연학습원민박촌입구구간	NNP
대정동구간	NNP
육일리구간	NNP
노변동구간	NNP
당본리구간	NNP
도롱리구간	NNP
학장동구간	NNP
고내리구간	NNP
천현동구간	NNP
신유리구간	NNP
예림리구간	NNP
상전면월포휴게소구간	NNP
갈마곡리구간	NNP
신흥초등학교구간	NNP
금당리구간	NNP
복실리구간	NNP
가례리구간	NNP
소주동구간	NNP
회정동구간	NNP
감서리구간	NNP
계산리구간	NNP
달동구간	NNP
분천리구간	NNP
단원리구간	NNP
정대리구간	NNP
외율리구간	NNP
불모산동구간	NNP
농암면수예리구간	NNP
정상구간	NNP
회남재길구간	NNP
청리구간	NNP
가락리구간	NNP
국촌리구간	NNP
제남리구간	NNP
망지산길구간	NNP
월정리구간	NNP
신평리구간	NNP
두음리구간	NNP
교동구간	NNP
내계길구간	NNP
연동리구간	NNP
의암리구간	NNP
수헐리구간	NNP
구왕리구간	NNP
대전외국어	NNP
고등학교구간	NNP
영포리구간	NNP
일선리구간	NNP
백록리구간	NNP
현성산길구간	NNP
추정리구간	NNP
형곡동비둘기아파트내입구구간	NNP
제천과수원구간	NNP
단양리구간	NNP
도직리구간	NNP
정자리구간	NNP
월송리구간	NNP
국화리구간	NNP
마룡리구간	NNP
대동면사무소구간	NNP
서서학동구간	NNP
하서리구간	NNP
내일리구간	NNP
죽파리구간	NNP
민가구간	NNP
두산리구간	NNP
태인동구간	NNP
대송리구간	NNP
하례리구간	NNP
생목동구간	NNP
야음동구간	NNP
장선리구간	NNP
서석동구간	NNP
천태리구간	NNP
지사동구간	NNP
초봉리구간	NNP
가좌동구간	NNP
중소기업개발원등산로입구구간	NNP
이명리구간	NNP
가선리구간	NNP
감정리구간	NNP
염호리구간	NNP
지흥동구간	NNP
문곡리구간	NNP
문학동	NNP
자율방범대구간	NNP
신감리구간	NNP
엄궁동구간	NNP
서사리구간	NNP
용장리구간	NNP
성대리구간	NNP
단고리구간	NNP
구사리구간	NNP
한양홍제아파트구간	NNP
어룡산구간	NNP
성산리구간	NNP
방현동구간	NNP
늘막골구간	NNP
하석리구간	NNP
개화동구간	NNP
안성리구간	NNP
손항길구간	NNP
지족동구간	NNP
양덕원리구간	NNP
내산리구간	NNP
장군봉길구간	NNP
고란리구간	NNP
협석리구간	NNP
회양리구간	NNP
용추길구간	NNP
덕월동구간	NNP
월남동구간	NNP
청풍동구간	NNP
늘목리구간	NNP
장교리구간	NNP
고감리구간	NNP
대광리구간	NNP
동서학동구간	NNP
송곡리	NNP
예비군	NNP
훈련장구간	NNP
구미역남쪽입구구간	NNP
죽문리구간	NNP
상구리구간	NNP
황용동구간	NNP
하금리구간	NNP
봉산리나눔길구간	NNP
왜관리구간	NNP
용두동구간	NNP
쌍달리구간	NNP
원기리구간	NNP
지천동구간	NNP
삼화리구간	NNP
명월리구간	NNP
보석리구간	NNP
세미오름구간	NNP
여양리구간	NNP
공기마을	NNP
초입구간	NNP
장사동구간	NNP
척지리구간	NNP
오등동구간	NNP
방일리구간	NNP
북장리구간	NNP
우사리구간	NNP
남대문리구간	NNP
관작리구간	NNP
문락리구간	NNP
무림리구간	NNP
형곡동체육시설입구구간	NNP
중군리구간	NNP
안심사구간	NNP
삼정삼거리구간	NNP
고양동구간	NNP
월백리구간	NNP
흥촌리구간	NNP
무거동구간	NNP
손동리구간	NNP
송석리구간	NNP
초동리구간	NNP
범방동구간	NNP
지개리구간	NNP
음양리구간	NNP
황리구간	NNP
청소리구간	NNP
선제리구간	NNP
의상봉길구간	NNP
신례리구간	NNP
운곡동구간	NNP
중간오름길구간	NNP
진현동구간	NNP
천당리구간	NNP
장은리구간	NNP
대자동길	NNP
도로입구구간	NNP
구서리구간	NNP
동곡리구간	NNP
백산리구간	NNP
관음리구간	NNP
우동구간	NNP
일중리구간	NNP
동대리구간	NNP
발한동구간	NNP
춘전리구간	NNP
매화리구간	NNP
용계리구간	NNP
옥천동구간	NNP
춘의동구간	NNP
청계리구간	NNP
덕전리구간	NNP
갈천리구간	NNP
신서동구간	NNP
우천리구간	NNP
광하리구간	NNP
용두봉구간	NNP
감이동구간	NNP
남장동구간	NNP
홍은동구간	NNP
하봉암동구간	NNP
북리구간	NNP
증곡리구간	NNP
운림동구간	NNP
서대문구홍은동벽산아파트관리사무	NNP
욱수동구간	NNP
상현동구간	NNP
지남리구간	NNP
문촌리구간	NNP
구미역후단지입구구역구간	NNP
중노송동구간	NNP
수하리구간	NNP
귀현동구간	NNP
제산리구간	NNP
눌산리구간	NNP
교동등산로	NNP
다죽리구간	NNP
남악리구간	NNP
합리마을	NNP
상단구간	NNP
영승리구간	NNP
홍지동구간	NNP
어흘리구간	NNP
역촌동구간	NNP
상효동구간	NNP
강선사구간	NNP
북상길구간	NNP
해안동구간	NNP
대상리구간	NNP
평복리구간	NNP
아주동구간	NNP
초록리구간	NNP
명정동구간	NNP
덕진리구간	NNP
봉곡동구간	NNP
영흥면내리구간	NNP
원내동구간	NNP
도북리구간	NNP
가주동구간	NNP
주산동구간	NNP
후곡리구간	NNP
신도리구간	NNP
고창리구간	NNP
봉항리구간	NNP
사파정동구간	NNP
세출리구간	NNP
신기리구간	NNP
석동동구간	NNP
율전리마을안길	NNP
삼달리구간	NNP
하동리구간	NNP
신론리구간	NNP
가운동구간	NNP
황락리구간	NNP
국포리구간	NNP
봉계리구간	NNP
내발산동구간	NNP
호매실동구간	NNP
심포리구간	NNP
강정길구간	NNP
한수종합조경구간	NNP
성덕리구간	NNP
발산리구간	NNP
공촌동구간	NNP
지토리구간	NNP
주록리구간	NNP
고림동구간	NNP
선학동구간	NNP
수산동구간	NNP
어수정낚시터입구구간	NNP
대련리구간	NNP
도정리구간	NNP
탑포리구간	NNP
함지산구간	NNP
도덕산구간	NNP
석산리구간	NNP
도문리구간	NNP
경기	NNP
군포	NNP
수리산	NNP
역구간	NNP
장승리구간	NNP
상정마을구간	NNP
호평동구간	NNP
묵어리구간	NNP
월곡동구간	NNP
명신여고	NNP
뒷편구간	NNP
성산고등학교구간	NNP
농은리구간	NNP
수룡리구간	NNP
학용동구간	NNP
법성리구간	NNP
노석리구간	NNP
월남리구간	NNP
정림리구간	NNP
명산길구간	NNP
김량장동구간	NNP
월가리구간	NNP
서동	NNP
미나리밭분기점구간	NNP
화촌면	NNP
장평리구간	NNP
구룡동구간	NNP
괴정동구간	NNP
가수동구간	NNP
가실리구간	NNP
두가리구간	NNP
충무시설	NNP
정자입구구간	NNP
지축동구간	NNP
고제저수지길구간	NNP
운회리구간	NNP
나원리구간	NNP
갈산리구간	NNP
족은바리메소독악구간	NNP
오미리구간	NNP
중평리구간	NNP
당산리구간	NNP
백석리구간	NNP
거진리구간	NNP
광령리구간	NNP
대천리구간	NNP
후기리구간	NNP
선리구간	NNP
청평리구간	NNP
수부리구간	NNP
사산리구간	NNP
유양동구간	NNP
산정리구간	NNP
모정리구간	NNP
평동리구간	NNP
소천리구간	NNP
당리구간	NNP
각화사구간	NNP
감악로길구간	NNP
향한리구간	NNP
원창리구간	NNP
김용리구간	NNP
동관리구간	NNP
영리구간	NNP
와여리구간	NNP
천촌리구간	NNP
태봉리구간	NNP
농로	NNP
탑동동구간	NNP
자은초등학교구간	NNP
대각리구간	NNP
가시리구간	NNP
마일리구간	NNP
방목리구간	NNP
마쌍리구간	NNP
재송동구간	NNP
병성동구간	NNP
방성리구간	NNP
함열리구간	NNP
상비재길구간	NNP
의동길구간	NNP
신철원리구간	NNP
하거노리구간	NNP
원암리구간	NNP
동호리구간	NNP
법수리구간	NNP
율길리구간	NNP
신점리구간	NNP
분적산정상구간	NNP
개포동구간	NNP
장풍리구간	NNP
동완산동구간	NNP
중산리구간	NNP
금산초등학교옆구간	NNP
황길동구간	NNP
화천리구간	NNP
색장동구간	NNP
장천동구간	NNP
월용리구간	NNP
마공리구간	NNP
대신리구간	NNP
구석리구간	NNP
입동리구간	NNP
석탑리구간	NNP
거기길구간	NNP
오봉산입구구간	NNP
반여동구간	NNP
은탄리구간	NNP
송평리구간	NNP
양곡동구간	NNP
월봉리구간	NNP
묵곡리구간	NNP
조음리구간	NNP
장기길구간	NNP
숙암리구간	NNP
덕치리구간	NNP
중리구간	NNP
구복리구간	NNP
어곡동구간	NNP
백천리구간	NNP
운종리구간	NNP
쌍태리구간	NNP
지월리구간	NNP
구례리구간	NNP
근산동구간	NNP
매월리구간	NNP
운농리구간	NNP
내룡리구간	NNP
수월리구간	NNP
건천리구간	NNP
세동리구간	NNP
오도산휴양림길구간	NNP
연희동구간	NNP
도곡리구간	NNP
송풍동구간	NNP
서대문구청구간	NNP
화장동구간	NNP
가탑리구간	NNP
향동리구간	NNP
추동구간	NNP
율전리구간	NNP
개신동구간	NNP
함평리구간	NNP
과학고구간	NNP
상인동구간	NNP
북한동구간	NNP
진벌리구간	NNP
장상동구간	NNP
방산동구간	NNP
현화리구간	NNP
평활리구간	NNP
상모리구간	NNP
선황리구간	NNP
산월리구간	NNP
숙곡리구간	NNP
활성동구간	NNP
금곡동구간	NNP
신림리구간	NNP
앙암바위구간	NNP
와야리구간	NNP
남통동구간	NNP
하시동리구간	NNP
명장동구간	NNP
고법리구간	NNP
칠성리구간	NNP
화율리구간	NNP
상천저수지길구간	NNP
지행동구간	NNP
영학리구간	NNP
비파리구간	NNP
산여리구간	NNP
남통고개아래입구구간	NNP
덕곡동구간	NNP
운연동구간	NNP
정서리구간	NNP
사점리구간	NNP
구성리구간	NNP
달성군	NNP
다사읍	NNP
강정리구간	NNP
상리구간	NNP
학일리구간	NNP
봉산리	NNP
출구구간	NNP
흘리구간	NNP
효평동구간	NNP
약수리구간	NNP
덕유리구간	NNP
연동마을주차장구간	NNP
풍덕천동구간	NNP
여래미리구간	NNP
명천동구간	NNP
제비리구간	NNP
아막리구간	NNP
견동리구간	NNP
송말리구간	NNP
청계동구간	NNP
자안리구간	NNP
수인리구간	NNP
화곡동구간	NNP
계상리구간	NNP
석남약수터	NNP
구간	NNP
화원리구간	NNP
오룡리구간	NNP
다곡리구간	NNP
옥계리구간	NNP
용탄리구간	NNP
화안리구간	NNP
소류지구간	NNP
자연휴양림구간	NNP
도관리구간	NNP
도사리구간	NNP
사기리구간	NNP
범학리구간	NNP
동동리구간	NNP
도마리구간	NNP
용흥동구간	NNP
백천동구간	NNP
수재길구간	NNP
사곡동숯가마좌측입구구간	NNP
월림리구간	NNP
용성면	NNP
곡신리구간	NNP
고촌리구간	NNP
대덕리은선암부근구간	NNP
중앙백신연구소구간	NNP
오분동구간	NNP
마장재옛길구간	NNP
평촌리구간	NNP
둔리구간	NNP
한덕리구간	NNP
후사리구간	NNP
대양동구간	NNP
상마읍리구간	NNP
산계리구간	NNP
수성리구간	NNP
석남동구간	NNP
월굴리구간	NNP
법평리구간	NNP
계산동구간	NNP
두모동구간	NNP
진의리	NNP
오산입구구간	NNP
득명리구간	NNP
회곡리구간	NNP
주아리구간	NNP
팔괴리구간	NNP
미산동구간	NNP
누교리구간	NNP
울대리구간	NNP
황곡리구간	NNP
양구군청구간	NNP
동두고개구간	NNP
성연리구간	NNP
서대문구홍은동신계아파트구간	NNP
삼태리구간	NNP
청요리구간	NNP
용담동구간	NNP
갈전리구간	NNP
시곡리구간	NNP
평전다리길구간	NNP
오궁리구간	NNP
내백리구간	NNP
어곡리구간	NNP
외송리구간	NNP
양정동구간	NNP
화지리구간	NNP
마을입구구간	NNP
형남중학교좌측입구구간	NNP
도계리구간	NNP
도학동구간	NNP
방촌리구간	NNP
포산리구간	NNP
동면리구간	NNP
동일리구간	NNP
신탄진동구간	NNP
차산리구간	NNP
읍하리구간	NNP
월운리구간	NNP
수리산	NNP
수암터널	NNP
밑구간	NNP
미도빌라	NNP
다동	NNP
뒤구간	NNP
주중리구간	NNP
개금동구간	NNP
몽산둘레길	NNP
이동구간	NNP
삼거동구간	NNP
송문리구간	NNP
헬기장가는길구간	NNP
장남리구간	NNP
삼가동구간	NNP
양길리구간	NNP
내석리구간	NNP
죽능리구간	NNP
거진읍	NNP
용하리구간	NNP
송산리구간	NNP
상수월길구간	NNP
형곡동형일초등학교입구구간	NNP
신정동구간	NNP
원당길구간	NNP
청룡길구간	NNP
주물리구간	NNP
구도동구간	NNP
대승사구간	NNP
수망리구간	NNP
초장동구간	NNP
득량동구간	NNP
수성동구간	NNP
대승사입구구간	NNP
향교동구간	NNP
석천리구간	NNP
황방리구간	NNP
회암동구간	NNP
칠전동구간	NNP
청곡리구간	NNP
구천리구간	NNP
사거리구간	NNP
우곡리구간	NNP
학구리구간	NNP
장평리구간	NNP
고성리구간	NNP
입암리구간	NNP
현성산길	NNP
구간	NNP
대신동구간	NNP
산내주공아파트후문구간	NNP
쌍령동구간	NNP
죽천리구간	NNP
미수동구간	NNP
어의곡리구간	NNP
서리구간	NNP
고정리구간	NNP
청리전원마을구간	NNP
신사리구간	NNP
광암동구간	NNP
대전	NNP
외국어	NNP
고등학교구간	NNP
국동구간	NNP
빼울약수터구간	NNP
가용리구간	NNP
포천리구간	NNP
어두니마을구간	NNP
주문리구간	NNP
여래리구간	NNP
교천리구간	NNP
영전리구간	NNP
서대문구홍은동포방터길구간	NNP
능교리구간	NNP
정자동구간	NNP
내암리구간	NNP
녹산동구간	NNP
중부동구간	NNP
대성여중고교구간	NNP
인곡리구간	NNP
용강동구간	NNP
능강리구간	NNP
아사리구간	NNP
선부동구간	NNP
약천리구간	NNP
모례리구간	NNP
금정동구간	NNP
흥월리구간	NNP
구서동구간	NNP
도화담리구간	NNP
고선리구간	NNP
본천리구간	NNP
하정리구간	NNP
법동구간	NNP
봉죽리구간	NNP
중원리구간	NNP
사암리구간	NNP
안평리구간	NNP
고계리구간	NNP
우산리구간	NNP
안포리구간	NNP
탕곡리구간	NNP
하송리구간	NNP
오태동성기태병원뒤입구구간	NNP
담안리구간	NNP
고운리구간	NNP
화악리구간	NNP
신례원리구간	NNP
한동리구간	NNP
지천리구간	NNP
아동리구간	NNP
반월리구간	NNP
백자리구간	NNP
마산리구간	NNP
일신동구간	NNP
상태동리구간	NNP
봉원동구간	NNP
용곡동구간	NNP
현내리구간	NNP
재산리구간	NNP
동림동구간	NNP
내장포길구간	NNP
성읍리구간	NNP
문혜리구간	NNP
어물리구간	NNP
상현리구간	NNP
중리리구간	NNP
창선리구간	NNP
사양리구간	NNP
몰운리구간	NNP
금어리구간	NNP
송학리구간	NNP
시장리구간	NNP
봉양동구간	NNP
양동리구간	NNP
이안면구미리구간	NNP
문래리구간	NNP
장흥동구간	NNP
용현리구간	NNP
막계동구간	NNP
이달봉오름구간	NNP
원방리구간	NNP
자일동구간	NNP
서무리구간	NNP
만흥리구간	NNP
천전리구간	NNP
당수동구간	NNP
초계리구간	NNP
남성리구간	NNP
가려리구간	NNP
작성산	NNP
임도구간	NNP
마을길	NNP
중문동구간	NNP
한진종합연구원구간	NNP
감성리구간	NNP
죽곡리구간	NNP
면목동구간	NNP
낭월동임도구간	NNP
도중리구간	NNP
용정리구간	NNP
매곡리구간	NNP
안서동구간	NNP
흘산리구간	NNP
자산동구간	NNP
종민동구간	NNP
사곡동송원사입구구간	NNP
양화리구간	NNP
괴평리구간	NNP
산학리구간	NNP
면동길구간	NNP
원당리구간	NNP
달산리구간	NNP
아라일동구간	NNP
예당리구간	NNP
노상리구간	NNP
산음리구간	NNP
아리구간	NNP
건등리구간	NNP
둔산동구간	NNP
저산리구간	NNP
임기리구간	NNP
도개리구간	NNP
남사리구간	NNP
비평리구간	NNP
삼천동구간	NNP
송사리구간	NNP
휴게소길구간	NNP
당리동구간	NNP
후사포리구간	NNP
죽전동구간	NNP
경상리구간	NNP
상하동구간	NNP
용암리구간	NNP
하계리구간	NNP
봉학리구간	NNP
광정리구간	NNP
십이폭포입구구간	NNP
이안면	NNP
안룡리	NNP
안룡약수터구간	NNP
형곡동장애인복지관건너편입구구간	NNP
박달리구간	NNP
산호동구간	NNP
상오리구간	NNP
시미리구간	NNP
창림리구간	NNP
세미소구간	NNP
양산동구간	NNP
문정리구간	NNP
현암리구간	NNP
금수리구간	NNP
선문대본관구간	NNP
원달리구간	NNP
득수리구간	NNP
송포리구간	NNP
봉서리구간	NNP
모점리구간	NNP
사곡동구간	NNP
백두대간구간	NNP
반곡리구간	NNP
연산리구간	NNP
두호동구간	NNP
무성그린맨션구간	NNP
운화리구간	NNP
금광길구간	NNP
외룡리구간	NNP
명덕리구간	NNP
생철리구간	NNP
시목리구간	NNP
백운동구간	NNP
유계리구간	NNP
도덕리구간	NNP
해리구간	NNP
영대리구간	NNP
방신리구간	NNP
해곡동구간	NNP
아침가리	NNP
계곡	NNP
트레킹	NNP
구간	NNP
심곡리구간	NNP
중흥리구간	NNP
신전리구간	NNP
거열산성길구간	NNP
신덕리구간	NNP
하천리구간	NNP
계양산정상송전탑길구간	NNP
마전동구간	NNP
계수동구간	NNP
육단리구간	NNP
북군동구간	NNP
이달이촛대봉구간	NNP
학계리구간	NNP
저전동구간	NNP
삼월리구간	NNP
나교리구간	NNP
포항동부교회구간	NNP
용월리구간	NNP
우산동구간	NNP
팔봉리구간	NNP
통삼리구간	NNP
구성동구간	NNP
직전리구간	NNP
수예리구간	NNP
삼송리구간	NNP
덕고개등경수구간	NNP
매지리구간	NNP
심방길구간	NNP
세산리구간	NNP
개산리구간	NNP
고서리구간	NNP
송천동구간	NNP
동천리구간	NNP
당산농공단지길구간	NNP
진동리구간	NNP
제내리구간	NNP
방하목리구간	NNP
등고리구간	NNP
덕포리구간	NNP
석정리구간	NNP
성법리구간	NNP
남명리구간	NNP
방리구간	NNP
운봉리구간	NNP
와룡동구간	NNP
양교리구간	NNP
토성리구간	NNP
운암리구간	NNP
갈용리구간	NNP
철암동구간	NNP
동화리구간	NNP
선문대서문구간	NNP
신월리구간	NNP
늘밭길구간	NNP
남구진월동구간	NNP
산평리구간	NNP
광안동구간	NNP
연암동구간	NNP
소정길구간	NNP
용수동구간	NNP
방동리구간	NNP
지내동구간	NNP
백운리구간	NNP
적리구간	NNP
감로암구간	NNP
각산동구간	NNP
유산로구간	NNP
희곡리구간	NNP
시례리구간	NNP
성암리구간	NNP
장곡리구간	NNP
학리구간	NNP
경반리탐방로	NNP
난곡동구간	NNP
본촌리구간	NNP
석항리구간	NNP
유량리구간	NNP
사파동구간	NNP
무릉리구간	NNP
곽지리구간	NNP
구호동구간	NNP
묵현리구간	NNP
덕충동구간	NNP
강제동구간	NNP
마장재길구간	NNP
삼호동구간	NNP
유포리구간	NNP
은사리구간	NNP
대각사구간	NNP
광산동구간	NNP
청량리동구간	NNP
지로리구간	NNP
태전동구간	NNP
명호면관창리순환구간	NNP
중광정리구간	NNP
상귀리구간	NNP
다운동구간	NNP
죽리구간	NNP
박호동구간	NNP
평여동구간	NNP
고비길구간	NNP
오류리구간	NNP
도대리구간	NNP
자원동구간	NNP
내동리구간	NNP
수망령길	NNP
구간	NNP
죽헌동구간	NNP
전농동구간	NNP
오호리구간	NNP
낙산리구간	NNP
암남동구간	NNP
북평리구간	NNP
다리목	NNP
마을구간	NNP
수암봉입구	NNP
주차장구간	NNP
발리리구간	NNP
도일동구간	NNP
대양리구간	NNP
문지동구간	NNP
수입리구간	NNP
월하리구간	NNP
부평리구간	NNP
대한리구간	NNP
주동리구간	NNP
죽학리구간	NNP
정상배드민턴클럽구간	NNP
납안리구간	NNP
풍취리구간	NNP
추곡리구간	NNP
구현대아파트구간	NNP
송암동구간	NNP
해월리구간	NNP
화흥리구간	NNP
동해리구간	NNP
영평리구간	NNP
자곡동구간	NNP
고라리구간	NNP
읍상리구간	NNP
어성전리구간	NNP
모암리구간	NNP
일직동구간	NNP
노론리구간	NNP
팔미리구간	NNP
증동리구간	NNP
경백리구간	NNP
상사창동구간	NNP
용치리구간	NNP
산이리구간	NNP
애련리구간	NNP
수곡리구간	NNP
관동동구간	NNP
오전동구간	NNP
유마리구간	NNP
신성아파트구간	NNP
왕가봉촌구간	NNP
사음리구간	NNP
성내리구간	NNP
진부리구간	NNP
봉계동구간	NNP
무갑리구간	NNP
황계리구간	NNP
산남동구간	NNP
거두리구간	NNP
상적동구간	NNP
모리재길구간	NNP
군부대	NNP
사격장구간	NNP
오취리	NNP
오취마을구간	NNP
남계리구간	NNP
구장리구간	NNP
임초리구간	NNP
주리구간	NNP
도송리구간	NNP
구곡리구간	NNP
월미동구간	NNP
봉소리구간	NNP
동촌리구간	NNP
번천리구간	NNP
검산리구간	NNP
환호동구간	NNP
국우동구간	NNP
신문리구간	NNP
노곡리구간	NNP
만수동구간	NNP
윤정리구간	NNP
삼룡동구간	NNP
자운리구간	NNP
일암저수지구간	NNP
장화리구간	NNP
심중리구간	NNP
중계동구간	NNP
탄지리구간	NNP
장존동구간	NNP
용호리구간	NNP
부목리구간	NNP
중현리구간	NNP
세인청소년	NNP
수련원	NNP
초입구간	NNP
용당리구간	NNP
큰재길구간	NNP
청담리구간	NNP
호동골자연체험장구간	NNP
전민동구간	NNP
소도동구간	NNP
유신리구간	NNP
창녕리구간	NNP
명동리구간	NNP
삼양일동구간	NNP
유방동구간	NNP
오지리구간	NNP
마차진리구간	NNP
연지리구간	NNP
삼의리구간	NNP
상리리구간	NNP
금룡사좌측입구구간	NNP
남애리구간	NNP
종부리구간	NNP
소하동구간	NNP
대아리구간	NNP
형곡동삼성원뒤입구구간	NNP
말흘리구간	NNP
상법리구간	NNP
구기동구간	NNP
동수리구간	NNP
보령산구간	NNP
어지리구간	NNP
서산리구간	NNP
두동구간	NNP
근린공원산책로순환코스구간	NNP
온천리구간	NNP
그린랜드펜션구간	NNP
도평리구간	NNP
관저동구간	NNP
내당길구간	NNP
명곡리구간	NNP
황둔리구간	NNP
홍제동구간	NNP
가덕도동	NNP
주민센터구간	NNP
비봉리구간	NNP
이곡동구간	NNP
선교동구간	NNP
동항리구간	NNP
덕산리구간	NNP
두명리구간	NNP
금오동구간	NNP
내성리구간	NNP
교월리구간	NNP
다사면매곡리구간	NNP
봉명동구간	NNP
무건리구간	NNP
형남중학교입구구간	NNP
죽향리구간	NNP
수안리구간	NNP
서대리구간	NNP
항곡리구간	NNP
궁황리구간	NNP
장팔길구간	NNP
봉황동구간	NNP
동대동구간	NNP
이문리구간	NNP
운정길구간	NNP
상월곡동구간	NNP
남동구	NNP
도림동구간	NNP
화암리구간	NNP
황지동구간	NNP
양구읍상리곧은골구간	NNP
학천리구간	NNP
북산리구간	NNP
매송리구간	NNP
상장리구간	NNP
교암동구간	NNP
신흥리구간	NNP
용유리구간	NNP
칠곡군	NNP
왜관읍구간	NNP
궁산리구간	NNP
신안동구간	NNP
비룡동구간	NNP
박산리구간	NNP
동상리구간	NNP
정상부구간	NNP
위만리구간	NNP
하화계리구간	NNP
이곡리구간	NNP
송당리구간	NNP
화창리구간	NNP
서초동구간	NNP
교가리구간	NNP
상의리구간	NNP
천천리구간	NNP
송림리구간	NNP
도선리구간	NNP
면천향교구간	NNP
학선리구간	NNP
오태동상모고등학교건너편입구구간	NNP
용산동구간	NNP
중학동구간	NNP
상곡리구간	NNP
법흥리구간	NNP
성수리구간	NNP
추목동구간	NNP
주곡리구간	NNP
소사길구간	NNP
화북일동구간	NNP
계원리구간	NNP
상중리구간	NNP
내와리구간	NNP
연등동구간	NNP
풍암동구간	NNP
순지리구간	NNP
방제리구간	NNP
방천리구간	NNP
밤나무가든	NNP
입구구간	NNP
하사리구간	NNP
보목동구간	NNP
삼성	NNP
푸른아파트구간	NNP
여서동구간	NNP
기산리구간	NNP
방동구간	NNP
대성동구간	NNP
덕서리구간	NNP
용산리구간	NNP
형곡동대자연빌옆입구구간	NNP
사천리구간	NNP
설곡리구간	NNP
개천사주차장구간	NNP
평창트레일구간	NNP
운곡리구간	NNP
매곡동구간	NNP
상촌길구간	NNP
도마동구간	NNP
귀여리구간	NNP
노온사동구간	NNP
양산리구간	NNP
이티리구간	NNP
원지동구간	NNP
동선동구간	NNP
가천리구간	NNP
대장동구간	NNP
월평동구간	NNP
생달리구간	NNP
각화동구간	NNP
이화리구간	NNP
구정리구간	NNP
서정리구간	NNP
검성지구간	NNP
기린면현리구간	NNP
구강리구간	NNP
월천리구간	NNP
갈마동구간	NNP
본의리구간	NNP
마륜리구간	NNP
사내리구간	NNP
하산운동구간	NNP
대리구간	NNP
안심리구간	NNP
어서리구간	NNP
명곡동구간	NNP
서대문구홍제천변길구간	NNP
내유동구간	NNP
명성리구간	NNP
고은리구간	NNP
옹점리구간	NNP
가정리구간	NNP
좌사리구간	NNP
대문리구간	NNP
산덕리구간	NNP
방기리구간	NNP
효성동구간	NNP
가오작리구간	NNP
흥기리구간	NNP
봉현리구간	NNP
고한리구간	NNP
산장가든구간	NNP
성복동구간	NNP
인의동구간	NNP
선산보건소구간	NNP
신방동구간	NNP
둔덕리구간	NNP
호동골입구터널옆구간	NNP
양전리구간	NNP
용촌리구간	NNP
삼양리구간	NNP
가재리구간	NNP
지동리구간	NNP
조령리구간	NNP
율현리구간	NNP
대잠동구간	NNP
성원아파트구간	NNP
용수리구간	NNP
오태동상모교회뒤입구구간	NNP
덕소리구간	NNP
대학리구간	NNP
노치리구간	NNP
방산리구간	NNP
신창리구간	NNP
동천동구간	NNP
대방동구간	NNP
내촌길구간	NNP
금이동구간	NNP
녹전리구간	NNP
어단리구간	NNP
불암동구간	NNP
남구노대마을아래등산로입구구간	NNP
내월리구간	NNP
서봉리구간	NNP
덕명동구간	NNP
하월산리구간	NNP
백계리구간	NNP
형곡동찬물샘입구구간	NNP
옹달샘약수터구간	NNP
사동구간	NNP
다구리구간	NNP
희망리구간	NNP
창동구간	NNP
부암리부수바위마을앞다리건너편구	NNP
반계동구간	NNP
서외리구간	NNP
평산리구간	NNP
하촌동구간	NNP
제물포중학교구간	NNP
도남리구간	NNP
광장동구간	NNP
합강리구간	NNP
구절리구간	NNP
광무동구간	NNP
소로리구간	NNP
척번정리구간	NNP
동례리구간	NNP
미륵사지구간	NNP
왕현리구간	NNP
은월리구간	NNP
용복동구간	NNP
설마리구간	NNP
활산리구간	NNP
문산리구간	NNP
노현리구간	NNP
회문산자연휴양림매표소구간	NNP
죽포리구간	NNP
산성리구간	NNP
신엄리구간	NNP
가림리구간	NNP
회령리구간	NNP
하도리구간	NNP
안양동구간	NNP
염티리구간	NNP
산림교육관구간	NNP
화성리구간	NNP
용인농촌테마파크옆길구간	NNP
거현리구간	NNP
환희리구간	NNP
범왕리구간	NNP
신암리구간	NNP
화림리구간	NNP
신리구간	NNP
회성동구간	NNP
도동리구간	NNP
정봉길구간	NNP
직원리구간	NNP
횡산리구간	NNP
송내리구간	NNP
명암동구간	NNP
동외리구간	NNP
시흥동구간	NNP
성안동구간	NNP
쌍신동구간	NNP
세계리구간	NNP
산정동구간	NNP
가오동구간	NNP
신이리구간	NNP
가좌리구간	NNP
대중리구간	NNP
금평리구간	NNP
성남리구간	NNP
광암리구간	NNP
공전리구간	NNP
성당리구간	NNP
무연리구간	NNP
광원리구간	NNP
이원리구간	NNP
하원동구간	NNP
상일리구간	NNP
수정동구간	NNP
반석동구간	NNP
정곡리구간	NNP
상명리구간	NNP
영운리구간	NNP
영양리구간	NNP
미산리구간	NNP
정중리구간	NNP
설악동구간	NNP
옥전리구간	NNP
내도리구간	NNP
남정리구간	NNP
신문동구간	NNP
유산동구간	NNP
낙천리구간	NNP
추모공원길구간	NNP
유흥리구간	NNP
두무산길구간	NNP
장수동구간	NNP
임학동구간	NNP
예강리구간	NNP
신현동구간	NNP
새사미아파트구간	NNP
남통곡동왕벌식당입구구간	NNP
연당리구간	NNP
남통동대성지윗쪽입구구간	NNP
자연학습원민박촌입구구간	NNP
무이리구간	NNP
마치리구간	NNP
발연리구간	NNP
역전평리구간	NNP
봉산동구간	NNP
구봉리구간	NNP
여량리구간	NNP
삽존리구간	NNP
송한리구간	NNP
천마리구간	NNP
마강리구간	NNP
부곡동구간	NNP
감산리구간	NNP
내곡리구간	NNP
소림사길구간	NNP
홍법리구간	NNP
관한리구간	NNP
역북동구간	NNP
아산리구간	NNP
대학삼도구간	NNP
미음동구간	NNP
당림리구간	NNP
구평동구간	NNP
수월동구간	NNP
대평리구간	NNP
신부동구간	NNP
상림동구간	NNP
옥포동구간	NNP
묵리구간	NNP
석포리구간	NNP
엄광리구간	NNP
연수동구간	NNP
형곡동효종엄지마을입구구간	NNP
신복리구간	NNP
고현동구간	NNP
하갈동구간	NNP
삼산리구간	NNP
청정리구간	NNP
삼배리구간	NNP
용문사구간	NNP
물금리구간	NNP
등억알프스리구간	NNP
동가리구간	NNP
대명동구간	NNP
하사전리구간	NNP
무령리구간	NNP
신촌동구간	NNP
갈매동구간	NNP
상리동구간	NNP
소동리구간	NNP
사촌리구간	NNP
사호동구간	NNP
용농장구간	NNP
송죽리구간	NNP
신관동구간	NNP
여락리구간	NNP
굴지리구간	NNP
와초리구간	NNP
서매리구간	NNP
거마리구간	NNP
선원동구간	NNP
월계리구간	NNP
무촌리구간	NNP
개정동구간	NNP
불당동구간	NNP
해평리구간	NNP
신룡리구간	NNP
장승포동구간	NNP
성천리구간	NNP
신흑동구간	NNP
신방리구간	NNP
장락동구간	NNP
형곡동서현교회입구구간	NNP
궁기리구간	NNP
포남동구간	NNP
송곡리구간	NNP
관기리구간	NNP
갈구리구간	NNP
오진리구간	NNP
수유동구간	NNP
천곡리구간	NNP
각산리구간	NNP
태백산구간	NNP
범부리구간	NNP
풍암리구간	NNP
장수리구간	NNP
지석리구간	NNP
운평리구간	NNP
신상동구간	NNP
신남리구간	NNP
운대리구간	NNP
학산동구간	NNP
용소리구간	NNP
조성리구간	NNP
누리길	NNP
용화리구간	NNP
내손동구간	NNP
명암리구간	NNP
반송동구간	NNP
자등리구간	NNP
고대길구간	NNP
원평리구간	NNP
소학리구간	NNP
가아리구간	NNP
덕동리구간	NNP
하대동구간	NNP
조례동구간	NNP
백전리구간	NNP
당북리구간	NNP
주남동구간	NNP
토계리구간	NNP
승곡리구간	NNP
풍유동구간	NNP
말곡리구간	NNP
내삼리구간	NNP
진월동구간	NNP
부사동구간	NNP
외곡리구간	NNP
봉림리구간	NNP
전곡리구간	NNP
공암리구간	NNP
조동리구간	NNP
장치리구간	NNP
차곡리구간	NNP
수산봉구간	NNP
적목리구간	NNP
남부경찰서구간	NNP
중유리구간	NNP
가대리구간	NNP
하곡리구간	NNP
교산리구간	NNP
오십천주유소구간	NNP
신금리구간	NNP
선지리구간	NNP
임계리구간	NNP
주등산로	NNP
사평리구간	NNP
신영동구간	NNP
하구암리구간	NNP
천내리동산아파트옆입구구간	NNP
심천리구간	NNP
횡계리구간	NNP
안산	NNP
대야미역구간	NNP
대안리구간	NNP
와수리구간	NNP
강청리구간	NNP
가납리구간	NNP
응원리구간	NNP
염창동구간	NNP
영천사구간	NNP
성내동구간	NNP
홍제삼성래미안구간	NNP
모충동구간	NNP
관덕리구간	NNP
남부동구간	NNP
구만리구간	NNP
경사리구간	NNP
진조리구간	NNP
중눌리구간	NNP
장연리구간	NNP
옥과리구간	NNP
만월산터널구간	NNP
도리길구간	NNP
만흥동구간	NNP
도림리구간	NNP
동동구간	NNP
도림동구간	NNP
능내리구간	NNP
실원리구간	NNP
개수리구간	NNP
가목리구간	NNP
산양리구간	NNP
서흥리구간	NNP
용운동구간	NNP
회동리구간	NNP
구일리구간	NNP
권혜리구간	NNP
대연동구간	NNP
배점리구간	NNP
자양동구간	NNP
일부리구간	NNP
미천리구간	NNP
중산동구간	NNP
고암리구간	NNP
등임동구간	NNP
별내동구간	NNP
대등리구간	NNP
배덕리구간	NNP
석전동구간	NNP
송정동구간	NNP
온정리구간	NNP
운주사구간	NNP
희망탑구간	NNP
오계리구간	NNP
대보리	NNP
마을회관	NNP
구간	NNP
벽계리구간	NNP
가일리구간	NNP
별암리구간	NNP
서포리구간	NNP
태자리구간	NNP
조천리구간	NNP
청량리구간	NNP
입석리구간	NNP
덕림리구간	NNP
모산리구간	NNP
다방동구간	NNP
소호리구간	NNP
천리구간	NNP
황조리구간	NNP
만천리구간	NNP
도원리구간	NNP
풍호동구간	NNP
중동구간	NNP
대포동구간	NNP
석대동구간	NNP
연사리구간	NNP
사정동구간	NNP
갈남리구간	NNP
광명동구간	NNP
마평동구간	NNP
장동구간	NNP
중곡동구간	NNP
요당리구간	NNP
뼈재길구간	NNP
쌍암동구간	NNP
초정리구간	NNP
조둔리구간	NNP
효근리구간	NNP
선곡리구간	NNP
삼계리구간	NNP
장춘리구간	NNP
노곡동구간	NNP
남리구간	NNP
옥화리구간	NNP
고룡리구간	NNP
장림동구간	NNP
신원동구간	NNP
천동구간	NNP
상만리구간	NNP
만성동구간	NNP
무계동구간	NNP
냉천리구간	NNP
한계리구간	NNP
역리구간	NNP
임불길구간	NNP
읍내동구간	NNP
소림사구간	NNP
만화리구간	NNP
화수리구간	NNP
천성동구간	NNP
감만동구간	NNP
북수리구간	NNP
위안리구간	NNP
무성리구간	NNP
황상동구간	NNP
갈리구간	NNP
호곡리구간	NNP
감천동구간	NNP
수당리구간	NNP
군포시	NNP
수리고교	NNP
앞구간	NNP
한내리구간	NNP
연금리구간	NNP
흥룡리구간	NNP
인월리구간	NNP
대초리구간	NNP
중산골구간	NNP
군내리구간	NNP
덕봉리구간	NNP
내송리구간	NNP
내교리구간	NNP
대강면구간	NNP
안정리구간	NNP
계수리구간	NNP
북신동구간	NNP
양암길구간	NNP
대남리구간	NNP
산수동구간	NNP
월송동구간	NNP
장전평리구간	NNP
전두리구간	NNP
계백문구간	NNP
옥련동구간	NNP
고암동구간	NNP
옥마리구간	NNP
내기리구간	NNP
상초리구간	NNP
임자면삼두리장목제구간	NNP
석판리구간	NNP
천상리구간	NNP
주읍리구간	NNP
운학동구간	NNP
척북리구간	NNP
도수리구간	NNP
병산길구간	NNP
원리구간	NNP
동삼동구간	NNP
마천동구간	NNP
공덕산북서쪽구간	NNP
삼축리구간	NNP
소태리구간	NNP
마지리구간	NNP
평기리구간	NNP
노천리구간	NNP
시흥초소구간	NNP
북천리구간	NNP
노암동구간	NNP
누읍동구간	NNP
유평리구간	NNP
매리구간	NNP
추자리구간	NNP
태하리구간	NNP
문금리구간	NNP
옥련국제사격장구간	NNP
순화리구간	NNP
도전리구간	NNP
진포동구간	NNP
팔당역구간	NNP
온천동구간	NNP
보각사구간	NNP
연수리구간	NNP
비상리구간	NNP
학사리구간	NNP
황룡면	NNP
신기촌구간	NNP
선경빌라구간	NNP
우정동구간	NNP
삶의쉼터길구간	NNP
서대문지역자활센터구간	NNP
남동구간	NNP
작장리구간	NNP
이백리구간	NNP
평화리구간	NNP
옥포리구간	NNP
성재리구간	NNP
구조라리구간	NNP
하월천리구간	NNP
한소리구간	NNP
송산동구간	NNP
가풍리구간	NNP
봉오리구간	NNP
덕구리구간	NNP
시영아파트옆입구구간	NNP
남원리구간	NNP
실매리구간	NNP
무기리구간	NNP
아천동구간	NNP
영구리구간	NNP
벌천리구간	NNP
진관동구간	NNP
흥덕리구간	NNP
현대연립주택진입로구간	NNP
죽전리구간	NNP
대구면	NNP
사당리구간	NNP
이현동구간	NNP
서부동구간	NNP
태화동구간	NNP
백양리구간	NNP
대호동구간	NNP
부도가는길구간	NNP
마장리구간	NNP
학담리구간	NNP
오저리구간	NNP
고자리구간	NNP
백마체육공원방면구간	NNP
남촌리구간	NNP
달성군화원읍구간	NNP
형곡동구간	NNP
해망동구간	NNP
의탄리구간	NNP
청호리구간	NNP
인보리구간	NNP
무동리구간	NNP
이안면	NNP
구미리	NNP
마을회관구간	NNP
도화리구간	NNP
조곡동구간	NNP
서홍동구간	NNP
대야리구간	NNP
죽마리구간	NNP
대덕리구간	NNP
대강리구간	NNP
운남리구간	NNP
세촌리구간	NNP
행화리구간	NNP
용탄동구간	NNP
경현동구간	NNP
화산리구간	NNP
가목마을	NNP
회관구간	NNP
인덕동구간	NNP
형곡고등학교좌측입구구간	NNP
사송리구간	NNP
수망령길구간	NNP
중리동구간	NNP
한국천문영구원구간	NNP
외암리구간	NNP
퇴계원리구간	NNP
사도리구간	NNP
부운리구간	NNP
회리구간	NNP
문현동구간	NNP
우동리구간	NNP
명품리구간	NNP
매학리구간	NNP
낙동리구간	NNP
귀둔리구간	NNP
이당리구간	NNP
강화산성서문구관구간	NNP
정평리구간	NNP
논현동구간	NNP
석수동구간	NNP
화리구간	NNP
남기리구간	NNP
통동구간	NNP
묘리구간	NNP
신갈동구간	NNP
마즈막재구간	NNP
형곡동금룡사입구구간	NNP
옹암리구간	NNP
매원리구간	NNP
고모리구간	NNP
남면상수내리구간	NNP
심동리구간	NNP
문성리구간	NNP
모산동구간	NNP
낭월동구간	NNP
백이산둘레길	NNP
교촌리구간	NNP
소곡길구간	NNP
현곡리구간	NNP
단장리구간	NNP
회동동구간	NNP
판암동구간	NNP
곤룡길삼거리구간	NNP
도안동구간	NNP
심곡사구간	NNP
중도리구간	NNP
건입동구간	NNP
월매리구간	NNP
구평리구간	NNP
도이동구간	NNP
중전리구간	NNP
금호동심곡길구간	NNP
오도산길구간	NNP
장재동구간	NNP
동오리구간	NNP
백암리구간	NNP
하산리구간	NNP
정수리구간	NNP
인구리구간	NNP
웅진리구간	NNP
괴곡리구간	NNP
유룡리구간	NNP
매류리구간	NNP
구원리구간	NNP
박계리구간	NNP
금봉암길구간	NNP
상소동구간	NNP
학잠동구간	NNP
이평리구간	NNP
양사리구간	NNP
적덕리구간	NNP
서봉동구간	NNP
운수리구간	NNP
백석읍구간	NNP
도산리구간	NNP
천천면	NNP
비룡리	NNP
중상마을구간	NNP
성주리구간	NNP
문덕리구간	NNP
성화동구간	NNP
보정동구간	NNP
사직동구간	NNP
생촌리구간	NNP
낙상리구간	NNP
암석/전석/토사구간	NNP
신사동구간	NNP
가인리구간	NNP
완장리구간	NNP
둔내리구간	NNP
산성동구간	NNP
국동리구간	NNP
풍양면	NNP
송정리구간	NNP
미대동구간	NNP
율리구간	NNP
청기리구간	NNP
벼락바위길구간	NNP
노일리구간	NNP
간송리구간	NNP
검복리구간	NNP
활기리구간	NNP
토평동구간	NNP
매주리구간	NNP
향양리구간	NNP
응달동구간	NNP
송정리구간	NNP
주양리구간	NNP
강산리구간	NNP
용잠리구간	NNP
고단리구간	NNP
장방리구간	NNP
고대길	NNP
구간	NNP
화정면구간	NNP
매여동구간	NNP
삼층석탑길구간	NNP
삼문동구간	NNP
동구리구간	NNP
평사리구간	NNP
화목동구간	NNP
수곡동구간	NNP
석골사주차장구간	NNP
전하동구간	NNP
읍내리구간	NNP
교사리구간	NNP
역후진덕디오스빌옆입구구간	NNP
탑곡리구간	NNP
수점동구간	NNP
만촌동구간	NNP
서구불로동구간	NNP
진관리구간	NNP
상거노리구간	NNP
내지리구간	NNP
목계리구간	NNP
건지동구간	NNP
비하동구간	NNP
서선리구간	NNP
공수리구간	NNP
침산동구간	NNP
송강동구간	NNP
어소리구간	NNP
북부동구간	NNP
원호리구간	NNP
용화산자연휴양림구간	NNP
내방리구간	NNP
정림동구간	NNP
심곡동구간	NNP
임성리구간	NNP
도웅리구간	NNP
청도리구간	NNP
간척리구간	NNP
옥동구간	NNP
시락리구간	NNP
좌항리구간	NNP
명촌리구간	NNP
방량리구간	NNP
광평동구간	NNP
복수동구간	NNP
원남산길구간	NNP
관정리구간	NNP
상야리구간	NNP
산곡동구간	NNP
사연리구간	NNP
경화동구간	NNP
단군공원구간	NNP
복산리구간	NNP
상태서리구간	NNP
천평리구간	NNP
태평동구간	NNP
동활리구간	NNP
어촌리구간	NNP
상계동구간	NNP
서원리구간	NNP
방학동구간	NNP
덕교리구간	NNP
온곡길구간	NNP
지곶동구간	NNP
이성리구간	NNP
월곡리구간	NNP
신안리구간	NNP
유방샘길구간	NNP
도월리구간	NNP
임수리구간	NNP
민락동구간	NNP
의정부동구간	NNP
옥정리구간	NNP
선암동구간	NNP
아양동구간	NNP
봉천동구간	NNP
수암동구간	NNP
금학리구간	NNP
여좌동구간	NNP
신지리구간	NNP
상봉암동구간	NNP
용덕리구간	NNP
화현리구간	NNP
봉산대교구간	NNP
와현리구간	NNP
학포리구간	NNP
강학리구간	NNP
제일리구간	NNP
덕포동구간	NNP
송연리구간	NNP
응암동구간	NNP
내령리구간	NNP
청산리구간	NNP
고죽리구간	NNP
청수리구간	NNP
아곡리구간	NNP
중화계리구간	NNP
대전리구간	NNP
서변리구간	NNP
여만리구간	NNP
장현동구간	NNP
곡안리구간	NNP
삼회리구간	NNP
남심리구간	NNP
구래리구간	NNP
청량사입구구간	NNP
백여리구간	NNP
월호리구간	NNP
오남리구간	NNP
남곡리구간	NNP
월선리구간	NNP
남통동어르신의전당뒤입구구간	NNP
써래봉구간	NNP
관촌리구간	NNP
동전리구간	NNP
임당리구간	NNP
두성리구간	NNP
월막리구간	NNP
무학사구간	NNP
괘랑리구간	NNP
상월산리구간	NNP
자품리구간	NNP
만수리구간	NNP
누상동구간	NNP
수색동구간	NNP
진정리구간	NNP
우이동구간	NNP
덕천동구간	NNP
목상동구간	NNP
변동구간	NNP
우구치리구간	NNP
관리구간	NNP
유천동구간	NNP
향산리구간	NNP
예양리구간	NNP
대의면구간	NNP
석가네구간	NNP
어송리구간	NNP
양청리구간	NNP
화월리구간	NNP
금산리구간	NNP
내수리구간	NNP
구칠리구간	NNP
좌동구간	NNP
방이리구간	NNP
유천리구간	NNP
가지리구간	NNP
삼척병원밑쪽구간	NNP
인덕리구간	NNP
외장포길구간	NNP
용안면교동리구간	NNP
하소리구간	NNP
휴암동구간	NNP
웅치면	NNP
중산리구간	NNP
천연동구간	NNP
운교리구간	NNP
부곡리구간	NNP
장좌리구간	NNP
궁산근린공원길구간	NNP
봉산길구간	NNP
초중리구간	NNP
비지리구간	NNP
여천고등학교내	NNP
쉼터구간	NNP
영창리구간	NNP
율정동구간	NNP
평양리구간	NNP
원산리구간	NNP
유수암리구간	NNP
풍서리구간	NNP
백범공원구간	NNP
연상리구간	NNP
수암동	NNP
동막골구간	NNP
연파리구간	NNP
하수내구간	NNP
넘터길구간	NNP
흥덕동구간	NNP
용전리구간	NNP
수승대길구간	NNP
간석동구간	NNP
무수동구간	NNP
사림동구간	NNP
송곡리	NNP
예비군	NNP
훈련장입구구간	NNP
선촌리구간	NNP
율림리구간	NNP
멍에실마을	NNP
회관앞구간	NNP
구지리구간	NNP
고덕마을입구구간	NNP
생태경영림탐방로구간	NNP
석현동구간	NNP
삼길리구간	NNP
도암리구간	NNP
하수내길구간	NNP
방축동구간	NNP
산곡리구간	NNP
장동리구간	NNP
상기리구간	NNP
지암리구간	NNP
학곡리구간	NNP
마흘리구간	NNP
어론리구간	NNP
적곡리구간	NNP
예미리구간	NNP
천선동구간	NNP
복정동구간	NNP
낭산리구간	NNP
신오산길구간	NNP
신곡동구간	NNP
소사본동구간	NNP
남노일리구간	NNP
대동구간	NNP
황금동구간	NNP
본신리구간	NNP
가흥리구간	NNP
장원봉길	NNP
송촌리구간	NNP
장흥리구간	NNP
용두리구간	NNP
부연리구간	NNP
우계리구간	NNP
백둔리탐방로	NNP
화당리구간	NNP
신풍리구간	NNP
하소동구간	NNP
호암리구간	NNP
금화리구간	NNP
학동구간	NNP
시전동구간	NNP
벽송리구간	NNP
원계리구간	NNP
늑구리구간	NNP
유정리구간	NNP
안영동구간	NNP
방문리구간	NNP
석전리구간	NNP
오림리구간	NNP
사정리구간	NNP
장사리구간	NNP
명티리구간	NNP
양벌리구간	NNP
장속리구간	NNP
옥각리구간	NNP
신촌길구간	NNP
방현리구간	NNP
상금리구간	NNP
도흥리구간	NNP
약사동구간	NNP
안막동구간	NNP
고치리구간	NNP
뇌곡리구간	NNP
수철리구간	NNP
옥천리구간	NNP
형곡동푸른숲마을입구구간	NNP
원촌동구간	NNP
귀운동구간	NNP
지묘동구간	NNP
박월동구간	NNP
부산동구간	NNP
간중리구간	NNP
부원동구간	NNP
월명리구간	NNP
오월리구간	NNP
영산리구간	NNP
월포리구간	NNP
의전리구간	NNP
선흘리구간	NNP
동림리구간	NNP
삼성푸른	NNP
아파트구간	NNP
마사리구간	NNP
신봉동구간	NNP
장회리구간	NNP
용산길구간	NNP
용동구간	NNP
덕거리구간	NNP
은산리구간	NNP
원덕리구간	NNP
학명리구간	NNP
옥룡동구간	NNP
조왕사입구구간	NNP
소호동구간	NNP
황호동구간	NNP
화죽리구간	NNP
하옥리구간	NNP
농주리구간	NNP
덕수리구간	NNP
주야리구간	NNP
동고도리구간	NNP
완산시립도서관옆길구간	NNP
광영동구간	NNP
상문리구간	NNP
두야리구간	NNP
운학리구간	NNP
각산가을의전설식당뒤입구구간	NNP
서동구간	NNP
영락리구간	NNP
임실길구간	NNP
목촌리구간	NNP
어만리구간	NNP
조원동구간	NNP
안현동구간	NNP
내항동구간	NNP
송현리구간	NNP
계란리구간	NNP
도동구간	NNP
어린이동물원구간	NNP
철산동구간	NNP
상서리구간	NNP
송정카톨릭센터구간	NNP
나불리구간	NNP
원율리구간	NNP
연하리구간	NNP
마달리구간	NNP
갈담리구간	NNP
청학동구간	NNP
안인진리구간	NNP
외방리구간	NNP
삼효리구간	NNP
정각리구간	NNP
상하리구간	NNP
금상동구간	NNP
다대리구간	NNP
청룡동구간	NNP
교로리구간	NNP
함박리구간	NNP
무악동구간	NNP
웅천리구간	NNP
흥전리구간	NNP
상봉동구간	NNP
고봉리구간	NNP
다포리구간	NNP
용계동구간	NNP
원동구간	NNP
미사리구간	NNP
마곡리구간	NNP
대심리구간	NNP
대소리구간	NNP
주포리구간	NNP
낙풍리구간	NNP
대추골	NNP
입구구간	NNP
토월동구간	NNP
미룡동구간	NNP
감리구간	NNP
무수리구간	NNP
농안리구간	NNP
염곡동구간	NNP
방화동구간	NNP
금덕리구간	NNP
가능동구간	NNP
남평리구간	NNP
신반리구간	NNP
의지리구간	NNP
용추폭포구간	NNP
임도구간	NNP
신음동구간	NNP
살피재길구간	NNP
불암사구간	NNP
평릉동구간	NNP
가봉리구간	NNP
지리구간	NNP
상안리구간	NNP
무고리구간	NNP
개화리구간	NNP
학동리구간	NNP
황전리구간	NNP
수신리구간	NNP
옥인동구간	NNP
신원리구간	NNP
하판리구간	NNP
구학리구간	NNP
묵방리구간	NNP
하남리구간	NNP
백산동구간	NNP
도두일동구간	NNP
매촌리구간	NNP
계곡리구간	NNP
원농산길구간	NNP
우명리구간	NNP
여차리구간	NNP
도촌리구간	NNP
강정동구간	NNP
창우동구간	NNP
내미로리구간	NNP
쌍암리구간	NNP
의평리구간	NNP
전사포리구간	NNP
간매리구간	NNP
대석리구간	NNP
석곡리구간	NNP
물맞이길구간	NNP
주평리구간	NNP
용대리구간	NNP
십정동구간	NNP
쌍북리구간	NNP
신라리구간	NNP
만송동구간	NNP
대율리구간	NNP
병곡리구간	NNP
금성동구간	NNP
금이산성전망대구간	NNP
헬기장구간	NNP
도갑리구간	NNP
주촌리구간	NNP
어물동구간	NNP
수북리구간	NNP
지오리구간	NNP
도룡리구간	NNP
송전리구간	NNP
독산리구간	NNP
본리리구간	NNP
옥암리구간	NNP
신괴리구간	NNP
홍계리구간	NNP
태백동구간	NNP
대복리구간	NNP
중인동구간	NNP
가천동구간	NNP
수동리구간	NNP
호명동구간	NNP
봉황리구간	NNP
광천리구간	NNP
엄사리구간	NNP
효자리구간	NNP
봉명리구간	NNP
장요리구간	NNP
동부리구간	NNP
상천리구간	NNP
명학리구간	NNP
간양리구간	NNP
전망대구간	NNP
장박리구간	NNP
송현동구간	NNP
수회리구간	NNP
강산동구간	NNP
보광리구간	NNP
고산동구간	NNP
삼청리구간	NNP
상산곡동구간	NNP
내계리구간	NNP
자풍리구간	NNP
금천동구간	NNP
송강리구간	NNP
궁현리구간	NNP
언남동구간	NNP
월명동구간	NNP
봉선동구간	NNP
가리산리구간	NNP
대방리구간	NNP
수리구간	NNP
고풍리구간	NNP
강교리구간	NNP
용암동구간	NNP
이진리구간	NNP
여남리구간	NNP
쌍계사주차장구간	NNP
광산리구간	NNP
적하리구간	NNP
보손리구간	NNP
소정리구간	NNP
오리구간	NNP
엑스포	NNP
과학공원구간	NNP
가창리구간	NNP
마교리구간	NNP
가장동구간	NNP
신호리구간	NNP
자연유치원구간	NNP
옥서리구간	NNP
일봉리구간	NNP
별장빌라구간	NNP
금락리구간	NNP
우두산길구간	NNP
수호리구간	NNP
오금동구간	NNP
상동구간	NNP
지가동구간	NNP
금붕동구간	NNP
수서리구간	NNP
태룡리구간	NNP
도담리구간	NNP
창오리구간	NNP
중교리구간	NNP
도로구간	NNP
옥성리구간	NNP
창현리구간	NNP
예밀리구간	NNP
유강리구간	NNP
유가사구간	NNP
좌천리구간	NNP
중화리구간	NNP
산제치길구간	NNP
청덕동구간	NNP
산기슭공원구간	NNP
해남리구간	NNP
형곡동통나무집식당옆입구구간	NNP
계서리구간	NNP
군자동구간	NNP
다부리구간	NNP
하오안리구간	NNP
세화리구간	NNP
죽정동구간	NNP
용포리구간	NNP
거림리구간	NNP
용암산구간	NNP
형곡동서현교회뒤입구구간	NNP
금성리구간	NNP
각산청구아파트뒤입구구간	NNP
계동리구간	NNP
영통동구간	NNP
평암리구간	NNP
장항리구간	NNP
고사리구간	NNP
신용동구간	NNP
광덕리구간	NNP
기능마을구간	NNP
증리구간	NNP
마온리구간	NNP
덕남리구간	NNP
고례리구간	NNP
청원리구간	NNP
대덕초등학교구간	NNP
상색리구간	NNP
어전리구간	NNP
유동리구간	NNP
삼척병원앞구간	NNP
쌍동리구간	NNP
율하동구간	NNP
대창리구간	NNP
상암동구간	NNP
보림리구간	NNP
장안리구간	NNP
봉정리구간	NNP
초현리구간	NNP
방하리구간	NNP
서변동구간	NNP
가정동구간	NNP
구산동구간	NNP
중앙동구간	NNP
삼마치리구간	NNP
돗수골길구간	NNP
장전리구간	NNP
매전리구간	NNP
시우리구간	NNP
석우리구간	NNP
매남리구간	NNP
진암리구간	NNP
학전리구간	NNP
온의동구간	NNP
금호리구간	NNP
한빛타운구간	NNP
미당리구간	NNP
남산리구간	NNP
이목정리구간	NNP
옥당리구간	NNP
부곡동	NNP
금양중구간	NNP
장암동구간	NNP
금토동구간	NNP
매당리구간	NNP
남양리구간	NNP
공덕마을	NNP
초입구간	NNP
족은노꼬메오름구간	NNP
회문리구간	NNP
동점동구간	NNP
반천리구간	NNP
금선사구간	NNP
가포동구간	NNP
노동리구간	NNP
대불리구간	NNP
오도오름구간	NNP
상학리구간	NNP
봉래동구간	NNP
흥왕리구간	NNP
어암리구간	NNP
고척길구간	NNP
복지리구간	NNP
장지리구간	NNP
황죽리구간	NNP
청궁리구간	NNP
정산리구간	NNP
백학리	NNP
원각사구간	NNP
송포동구간	NNP
하태서리구간	NNP
노은동구간	NNP
어재리구간	NNP
구포동구간	NNP
학의동구간	NNP
호산리구간	NNP
장계리구간	NNP
시전리구간	NNP
금송리구간	NNP
인평리구간	NNP
대전공원묘지구간	NNP
운용리구간	NNP
금곡리구간	NNP
주서리구간	NNP
주성동구간	NNP
산수리구간	NNP
후죽리구간	NNP
조야동구간	NNP
오산리구간	NNP
오리리구간	NNP
화방리구간	NNP
덕학리구간	NNP
중동리구간	NNP
포동구간	NNP
순애원	NNP
길구간	NNP
토성면	NNP
용암리구간	NNP
인주리구간	NNP
안봉리구간	NNP
회학리구간	NNP
대곡리구간	NNP
춘송리구간	NNP
도룡동구간	NNP
하빈리구간	NNP
연기리구간	NNP
율촌리구간	NNP
성금리구간	NNP
연동구간	NNP
연산동구간	NNP
북아현동구간	NNP
부남리구간	NNP
상둔리구간	NNP
원미동구간	NNP
저동리구간	NNP
근곡리구간	NNP
창죽동구간	NNP
옥곤리구간	NNP
신성리구간	NNP
군동리구간	NNP
학정리구간	NNP
통사리구간	NNP
주봉리구간	NNP
양성리구간	NNP
유성	NNP
노은동구간	NNP
평계리구간	NNP
사곡동민방위교육장입구구간	NNP
가학리구간	NNP
마가다락방구간	NNP
한기리구간	NNP
난포리구간	NNP
지변동구간	NNP
배방리구간	NNP
성만리구간	NNP
목리구간	NNP
석문리구간	NNP
주암동구간	NNP
김재로	NNP
묘구간	NNP
오식도동구간	NNP
저동구간	NNP
호형리구간	NNP
사북리구간	NNP
성수산자연휴양림주차장구간	NNP
수청동구간	NNP
대항리구간	NNP
쌍용동구간	NNP
수정사구간	NNP
안동구간	NNP
산안리구간	NNP
마석우리구간	NNP
백학리구간	NNP
성곡동구간	NNP
낙성리구간	NNP
임고리구간	NNP
적암리구간	NNP
백조약수터구간	NNP
대기리구간	NNP
청용리구간	NNP
봉덕리구간	NNP
가송리구간	NNP
금악리구간	NNP
마하리구간	NNP
승부리구간	NNP
봉갑리구간	NNP
평중리구간	NNP
고등리구간	NNP
이만리구간	NNP
여량리마산치구간	NNP
부암동구간	NNP
서동공원구간	NNP
사수리구간	NNP
석강길구간	NNP
이충동구간	NNP
복장리구간	NNP
오향리구간	NNP
안민동구간	NNP
사월리구간	NNP
금성초등학교구간	NNP
삼인리구간	NNP
언별리구간	NNP
호당리구간	NNP
신하동구간	NNP
평산동구간	NNP
대능리구간	NNP
중방리구간	NNP
망주리구간	NNP
신용리구간	NNP
동송리구간	NNP
주월리구간	NNP
행촌리구간	NNP
내제리구간	NNP
산막리구간	NNP
풍동구간	NNP
지좌동구간	NNP
방곡리구간	NNP
봉성리구간	NNP
거운리구간	NNP
초량동구간	NNP
원동리구간	NNP
웅천동구간	NNP
소산오름구간	NNP
황운리구간	NNP
누하리구간	NNP
장승배기길구간	NNP
고달리구간	NNP
신왕리구간	NNP
무실동구간	NNP
정하동구간	NNP
미룡리구간	NNP
치산리구간	NNP
구미동구간	NNP
완전리구간	NNP
내대리구간	NNP
서대문구연희고지길구간	NNP
율이리구간	NNP
여삼리구간	NNP
운동동구간	NNP
박문수유물관구간	NNP
봉정동구간	NNP
해창리구간	NNP
두산동구간	NNP
능포동구간	NNP
방학리구간	NNP
용정동구간	NNP
어음리구간	NNP
대중식당구간	NNP
석구동구간	NNP
수락리구간	NNP
퇴천리구간	NNP
법환동구간	NNP
오천리구간	NNP
삼일리구간	NNP
동수농공단지구간	NNP
원평동구간	NNP
파산리구간	NNP
형곡동비둘기아파트옆입구구간	NNP
자연사박물간구간	NNP
마송리구간	NNP
불광동구간	NNP
법전리구간	NNP
현저동구간	NNP
지금동구간	NNP
헌신중학교구간	NNP
봉양면	NNP
도원리구간	NNP
동산리구간	NNP
구완동구간	NNP
대쌍령리구간	NNP
운산리구간	NNP
우전리구간	NNP
소양리구간	NNP
소성리구간	NNP
원통리구간	NNP
서구원당동구간	NNP
괴목리구간	NNP
각산대동아파트정문앞입구구간	NNP
자연학교구간	NNP
불이리구간	NNP
화곡리구간	NNP
명륜동구간	NNP
상가리구간	NNP
봉평동구간	NNP
굴화리구간	NNP
판문리구간	NNP
남내리구간	NNP
삼림문화휴양관구간	NNP
천안리구간	NNP
후평동구간	NNP
서석면청량리구간	NNP
장학리구간	NNP
학현리구간	NNP
웅진동구간	NNP
장전동구간	NNP
동부동구간	NNP
보현사구간	NNP
산촌리구간	NNP
성동리구간	NNP
구유동구간	NNP
옥계동구간	NNP
호음단맥구간	NNP
삼방동구간	NNP
연봉리구간	NNP
양지리구간	NNP
옥곡동구간	NNP
오투리조트등산로	NNP
신웅리구간	NNP
추풍령리구간	NNP
동향면	NNP
가막리구간	NNP
상광정리구간	NNP
구월리구간	NNP
상광교동구간	NNP
고무릉리구간	NNP
합성동구간	NNP
월성동구간	NNP
신당동구간	NNP
옥길리구간	NNP
종로구상명대학교뒷편구간	NNP
정양사구간	NNP
원소리구간	NNP
천마아파트구간	NNP
채지리구간	NNP
금오산자연학습원내입구구간	NNP
금사동구간	NNP
용능리구간	NNP
치일리구간	NNP
봉안사구간	NNP
화금리구간	NNP
상원리구간	NNP
우매리구간	NNP
백길리구간	NNP
우암동구간	NNP
창평동구간	NNP
내포리구간	NNP
북성동구간	NNP
도남동구간	NNP
가산리구간	NNP
삼락리구간	NNP
옥암동구간	NNP
오조리구간	NNP
남산둘레길구간	NNP
가장리구간	NNP
율세동구간	NNP
금사리구간	NNP
대천동구간	NNP
단계리구간	NNP
참나무평원길구간	NNP
연탄리구간	NNP
약수암구간	NNP
구월동구간	NNP
구영리구간	NNP
애당리구간	NNP
화암동구간	NNP
월학리구간	NNP
삼성인력개발원등산로입구구간	NNP
수만리구간	NNP
오륜동구간	NNP
증산동구간	NNP
둔전리구간	NNP
수동구간	NNP
오포리구간	NNP
나포리구간	NNP
아암리구간	NNP
운전리구간	NNP
대사리구간	NNP
소팽이구간	NNP
사기소리구간	NNP
지산동구간	NNP
도리구간	NNP
산야리구간	NNP
마북동구간	NNP
우수리구간	NNP
홍대연수원입구구간	NNP
이천리구간	NNP
연수사길구간	NNP
학익동구간	NNP
망정리구간	NNP
연죽리구간	NNP
동남리구간	NNP
팔야리구간	NNP
수항리구간	NNP
연화리구간	NNP
구암성당구간	NNP
장문리구간	NNP
어석리구간	NNP
법흥동구간	NNP
등촌리구간	NNP
고기리구간	NNP
수가동구간	NNP
주수리구간	NNP
지산리구간	NNP
후리구간	NNP
덕거길구간	NNP
원천리구간	NNP
봉호리구간	NNP
귀곡동구간	NNP
상번천리구간	NNP
이동교리구간	NNP
운치리구간	NNP
사창리구간	NNP
구암리구간	NNP
두창리구간	NNP
휴게소구간	NNP
멍에실임도구간	NNP
봉무동구간	NNP
개정리구간	NNP
정생동구간	NNP
음지리구간	NNP
구교리구간	NNP
위촌리구간	NNP
송하리구간	NNP
국전리구간	NNP
미륵리구간	NNP
내광리구간	NNP
남포리	NNP
버스정류장구간	NNP